Position,Team,P,W,D,L,F,A,HP,HW,HD,HL,HF,HA,AP,AW,AD,AL,AF,AA,Pts,GD,Ave,A_Ave,HA_Ave,AA_Ave,F_Ave,HF_Ave,AF_Ave,League_W %,League_D %,League_L %,MaxGame,CompletionRate %,Position %,League,Date,NextMatchDate
1,Zamalek,17,13,2,2,32,16,8,5,2,1,17,10,9,8,0,1,15,6,41,16,2.82,0.941176471,1.25,0.666666667,1.882352941,2.125,1.666666667,33.21917808,33.56164384,33.21917808,34,50,0.055555556,Egypt-Premier,2022/05/06,2022/05/10 20:00
1,Zamalek,17,13,2,2,32,16,8,5,2,1,17,10,9,8,0,1,15,6,41,16,2.82,0.941176471,1.25,0.666666667,1.882352941,2.125,1.666666667,33.21917808,33.56164384,33.21917808,34,50,0.055555556,Egypt-Premier,2022/05/06,2022/05/01 20:30
2,Al Ahly,14,10,3,1,32,10,7,6,1,0,14,1,7,4,2,1,18,9,33,22,3,0.714285714,0.142857143,1.285714286,2.285714286,2,2.571428571,33.21917808,33.56164384,33.21917808,34,41.2,0.111111111,Egypt-Premier,2022/05/06,2022/04/30 20:30
3,Pyramids,15,10,2,3,25,13,8,6,0,2,15,5,7,4,2,1,10,8,32,12,2.53,0.866666667,0.625,1.142857143,1.666666667,1.875,1.428571429,33.21917808,33.56164384,33.21917808,34,44.1,0.166666667,Egypt-Premier,2022/05/06,2022/05/01 20:30
3,Pyramids,15,10,2,3,25,13,8,6,0,2,15,5,7,4,2,1,10,8,32,12,2.53,0.866666667,0.625,1.142857143,1.666666667,1.875,1.428571429,33.21917808,33.56164384,33.21917808,34,44.1,0.166666667,Egypt-Premier,2022/05/06,2022/05/06 20:00
4,Future FC,16,8,4,4,28,14,8,5,2,1,14,6,8,3,2,3,14,8,28,14,2.62,0.875,0.75,1,1.75,1.75,1.75,33.21917808,33.56164384,33.21917808,34,47.1,0.222222222,Egypt-Premier,2022/05/06,2022/04/29 20:30
4,Future FC,16,8,4,4,28,14,8,5,2,1,14,6,8,3,2,3,14,8,28,14,2.62,0.875,0.75,1,1.75,1.75,1.75,33.21917808,33.56164384,33.21917808,34,47.1,0.222222222,Egypt-Premier,2022/05/06,2022/05/09 17:30
5,Smouha,16,7,6,3,20,17,7,6,1,0,15,5,9,1,5,3,5,12,27,3,2.31,1.0625,0.714285714,1.333333333,1.25,2.142857143,0.555555556,33.21917808,33.56164384,33.21917808,34,47.1,0.277777778,Egypt-Premier,2022/05/06,2022/05/06 20:00
6,Nat Bank Egy,16,6,5,5,19,17,8,5,1,2,11,6,8,1,4,3,8,11,23,2,2.25,1.0625,0.75,1.375,1.1875,1.375,1,33.21917808,33.56164384,33.21917808,34,47.1,0.333333333,Egypt-Premier,2022/05/06,2022/04/29 20:30
6,Nat Bank Egy,16,6,5,5,19,17,8,5,1,2,11,6,8,1,4,3,8,11,23,2,2.25,1.0625,0.75,1.375,1.1875,1.375,1,33.21917808,33.56164384,33.21917808,34,47.1,0.333333333,Egypt-Premier,2022/05/06,2022/05/09 20:00
7,Pharco,17,6,5,6,15,14,9,4,2,3,9,9,8,2,3,3,6,5,23,1,1.71,0.823529412,1,0.625,0.882352941,1,0.75,33.21917808,33.56164384,33.21917808,34,50,0.388888889,Egypt-Premier,2022/05/06,2022/05/09 17:30
8,El Geish,17,5,7,5,8,13,9,5,2,2,6,4,8,0,5,3,2,9,22,-5,1.24,0.764705882,0.444444444,1.125,0.470588235,0.666666667,0.25,33.21917808,33.56164384,33.21917808,34,50,0.444444444,Egypt-Premier,2022/05/06,2022/04/30 20:30
8,El Geish,17,5,7,5,8,13,9,5,2,2,6,4,8,0,5,3,2,9,22,-5,1.24,0.764705882,0.444444444,1.125,0.470588235,0.666666667,0.25,33.21917808,33.56164384,33.21917808,34,50,0.444444444,Egypt-Premier,2022/05/06,2022/05/09 20:00
9,ENPPI,16,4,8,4,17,19,8,2,5,1,9,8,8,2,3,3,8,11,20,-2,2.25,1.1875,1,1.375,1.0625,1.125,1,33.21917808,33.56164384,33.21917808,34,47.1,0.5,Egypt-Premier,2022/05/06,2022/04/29 20:30
9,ENPPI,16,4,8,4,17,19,8,2,5,1,9,8,8,2,3,3,8,11,20,-2,2.25,1.1875,1,1.375,1.0625,1.125,1,33.21917808,33.56164384,33.21917808,34,47.1,0.5,Egypt-Premier,2022/05/06,2022/05/10 20:00
10,Ghazl Mehal,17,4,8,5,15,20,8,2,5,1,11,8,9,2,3,4,4,12,20,-5,2.06,1.176470588,1,1.333333333,0.882352941,1.375,0.444444444,33.21917808,33.56164384,33.21917808,34,50,0.555555556,Egypt-Premier,2022/05/06,2022/04/30 20:30
11,Al Masry,15,4,7,4,18,17,8,2,4,2,9,10,7,2,3,2,9,7,19,1,2.33,1.133333333,1.25,1,1.2,1.125,1.285714286,33.21917808,33.56164384,33.21917808,34,44.1,0.611111111,Egypt-Premier,2022/05/06,2022/05/01 20:30
11,Al Masry,15,4,7,4,18,17,8,2,4,2,9,10,7,2,3,2,9,7,19,1,2.33,1.133333333,1.25,1,1.2,1.125,1.285714286,33.21917808,33.56164384,33.21917808,34,44.1,0.611111111,Egypt-Premier,2022/05/06,2022/05/06 17:30
12,Al Ittihad Eg,17,4,7,6,22,25,9,3,3,3,15,14,8,1,4,3,7,11,19,-3,2.76,1.470588235,1.555555556,1.375,1.294117647,1.666666667,0.875,33.21917808,33.56164384,33.21917808,34,50,0.666666667,Egypt-Premier,2022/05/06,2022/04/30 20:30
13,Ceramica Cle,17,3,9,5,14,18,8,2,4,2,7,9,9,1,5,3,7,9,18,-4,1.88,1.058823529,1.125,1,0.823529412,0.875,0.777777778,33.21917808,33.56164384,33.21917808,34,50,0.722222222,Egypt-Premier,2022/05/06,2022/04/30 20:30
13,Ceramica Cle,17,3,9,5,14,18,8,2,4,2,7,9,9,1,5,3,7,9,18,-4,1.88,1.058823529,1.125,1,0.823529412,0.875,0.777777778,33.21917808,33.56164384,33.21917808,34,50,0.722222222,Egypt-Premier,2022/05/06,2022/05/10 17:30
14,El Gounah,16,5,2,9,15,21,8,2,2,4,7,11,8,3,0,5,8,10,17,-6,2.25,1.3125,1.375,1.25,0.9375,0.875,1,33.21917808,33.56164384,33.21917808,34,47.1,0.777777778,Egypt-Premier,2022/05/06,2022/05/01 20:30
14,El Gounah,16,5,2,9,15,21,8,2,2,4,7,11,8,3,0,5,8,10,17,-6,2.25,1.3125,1.375,1.25,0.9375,0.875,1,33.21917808,33.56164384,33.21917808,34,47.1,0.777777778,Egypt-Premier,2022/05/06,2022/05/10 17:30
15,A Mokawloon,17,3,7,7,16,20,8,1,5,2,6,8,9,2,2,5,10,12,16,-4,2.12,1.176470588,1,1.333333333,0.941176471,0.75,1.111111111,33.21917808,33.56164384,33.21917808,34,50,0.833333333,Egypt-Premier,2022/05/06,2022/05/01 20:30
15,A Mokawloon,17,3,7,7,16,20,8,1,5,2,6,8,9,2,2,5,10,12,16,-4,2.12,1.176470588,1,1.333333333,0.941176471,0.75,1.111111111,33.21917808,33.56164384,33.21917808,34,50,0.833333333,Egypt-Premier,2022/05/06,2022/05/09 15:00
16,Ismaily,16,2,5,9,9,20,7,0,3,4,0,9,9,2,2,5,9,11,11,-11,1.81,1.25,1.285714286,1.222222222,0.5625,0,1,33.21917808,33.56164384,33.21917808,34,47.1,0.888888889,Egypt-Premier,2022/05/06,2022/05/06 17:30
16,Ismaily,16,2,5,9,9,20,7,0,3,4,0,9,9,2,2,5,9,11,11,-11,1.81,1.25,1.285714286,1.222222222,0.5625,0,1,33.21917808,33.56164384,33.21917808,34,47.1,0.888888889,Egypt-Premier,2022/05/06,2022/04/30 20:30
17,Misr Makasa,17,1,7,9,8,21,9,1,5,3,4,7,8,0,2,6,4,14,10,-13,1.71,1.235294118,0.777777778,1.75,0.470588235,0.444444444,0.5,33.21917808,33.56164384,33.21917808,34,50,0.944444444,Egypt-Premier,2022/05/06,2022/04/29 20:30
18,E Sh Dokhan,16,2,4,10,11,29,9,1,2,6,7,18,7,1,2,4,4,11,10,-18,2.5,1.8125,2,1.571428571,0.6875,0.777777778,0.571428571,33.21917808,33.56164384,33.21917808,34,47.1,1,Egypt-Premier,2022/05/06,2022/05/01 20:30
18,E Sh Dokhan,16,2,4,10,11,29,9,1,2,6,7,18,7,1,2,4,4,11,10,-18,2.5,1.8125,2,1.571428571,0.6875,0.777777778,0.571428571,33.21917808,33.56164384,33.21917808,34,47.1,1,Egypt-Premier,2022/05/06,2022/05/09 15:00
1,Real Madrid,34,25,6,3,73,29,17,12,4,1,38,13,17,13,2,2,35,16,81,44,3,0.852941176,0.764705882,0.941176471,2.147058824,2.235294118,2.058823529,35.44117647,29.11764706,35.44117647,38,89.5,0.05,Spain-La-Liga,2022/05/06,2022/05/08 20:00
2,Barcelona,34,19,9,6,63,34,17,11,2,4,34,16,17,8,7,2,29,18,66,29,2.85,1,0.941176471,1.058823529,1.852941176,2,1.705882353,35.44117647,29.11764706,35.44117647,38,89.5,0.1,Spain-La-Liga,2022/05/06,2022/05/01 20:00
2,Barcelona,34,19,9,6,63,34,17,11,2,4,34,16,17,8,7,2,29,18,66,29,2.85,1,0.941176471,1.058823529,1.852941176,2,1.705882353,35.44117647,29.11764706,35.44117647,38,89.5,0.1,Spain-La-Liga,2022/05/06,2022/05/10 20:30
2,Barcelona,34,19,9,6,63,34,17,11,2,4,34,16,17,8,7,2,29,18,66,29,2.85,1,0.941176471,1.058823529,1.852941176,2,1.705882353,35.44117647,29.11764706,35.44117647,38,89.5,0.1,Spain-La-Liga,2022/05/06,2022/05/07 20:00
3,Sevilla,34,17,13,4,50,28,17,11,5,1,35,17,17,6,8,3,15,11,64,22,2.29,0.823529412,1,0.647058824,1.470588235,2.058823529,0.882352941,35.44117647,29.11764706,35.44117647,38,89.5,0.15,Spain-La-Liga,2022/05/06,2022/05/08 15:15
4,Atl Madrid,34,18,7,9,59,41,17,11,4,2,31,15,17,7,3,7,28,26,61,18,2.94,1.205882353,0.882352941,1.529411765,1.735294118,1.823529412,1.647058824,35.44117647,29.11764706,35.44117647,38,89.5,0.2,Spain-La-Liga,2022/05/06,2022/05/08 20:00
5,Real Betis,34,17,7,10,56,38,17,9,2,6,31,20,17,8,5,4,25,18,58,18,2.76,1.117647059,1.176470588,1.058823529,1.647058824,1.823529412,1.470588235,35.44117647,29.11764706,35.44117647,38,89.5,0.25,Spain-La-Liga,2022/05/06,2022/05/07 20:00
5,Real Betis,34,17,7,10,56,38,17,9,2,6,31,20,17,8,5,4,25,18,58,18,2.76,1.117647059,1.176470588,1.058823529,1.647058824,1.823529412,1.470588235,35.44117647,29.11764706,35.44117647,38,89.5,0.25,Spain-La-Liga,2022/05/06,2022/05/02 20:00
5,Real Betis,34,17,7,10,56,38,17,9,2,6,31,20,17,8,5,4,25,18,58,18,2.76,1.117647059,1.176470588,1.058823529,1.647058824,1.823529412,1.470588235,35.44117647,29.11764706,35.44117647,38,89.5,0.25,Spain-La-Liga,2022/05/06,2022/05/10 18:00
6,Real Sociedad,34,15,11,8,33,32,17,9,5,3,12,7,17,6,6,5,21,25,56,1,1.91,0.941176471,0.411764706,1.470588235,0.970588235,0.705882353,1.235294118,35.44117647,29.11764706,35.44117647,38,89.5,0.3,Spain-La-Liga,2022/05/06,2022/05/06 20:00
7,Villarreal,34,14,10,10,54,33,17,10,5,2,38,15,17,4,5,8,16,18,52,21,2.56,0.970588235,0.882352941,1.058823529,1.588235294,2.235294118,0.941176471,35.44117647,29.11764706,35.44117647,38,89.5,0.35,Spain-La-Liga,2022/05/06,2022/05/08 15:15
8,Atl Bilbao,34,13,12,9,41,34,17,9,3,5,27,18,17,4,9,4,14,16,51,7,2.21,1,1.058823529,0.941176471,1.205882353,1.588235294,0.823529412,35.44117647,29.11764706,35.44117647,38,89.5,0.4,Spain-La-Liga,2022/05/06,2022/05/07 15:15
8,Atl Bilbao,34,13,12,9,41,34,17,9,3,5,27,18,17,4,9,4,14,16,51,7,2.21,1,1.058823529,0.941176471,1.205882353,1.588235294,0.823529412,35.44117647,29.11764706,35.44117647,38,89.5,0.4,Spain-La-Liga,2022/05/06,2022/05/10 19:00
9,Osasuna,34,12,9,13,35,45,17,5,6,6,16,23,17,7,3,7,19,22,45,-10,2.35,1.323529412,1.352941176,1.294117647,1.029411765,0.941176471,1.117647059,35.44117647,29.11764706,35.44117647,38,89.5,0.45,Spain-La-Liga,2022/05/06,2022/05/08 17:30
10,Valencia,34,10,13,11,45,49,17,5,8,4,24,21,17,5,5,7,21,28,43,-4,2.76,1.441176471,1.235294118,1.647058824,1.323529412,1.411764706,1.235294118,35.44117647,29.11764706,35.44117647,38,89.5,0.5,Spain-La-Liga,2022/05/06,2022/05/10 18:00
10,Valencia,34,10,13,11,45,49,17,5,8,4,24,21,17,5,5,7,21,28,43,-4,2.76,1.441176471,1.235294118,1.647058824,1.323529412,1.411764706,1.235294118,35.44117647,29.11764706,35.44117647,38,89.5,0.5,Spain-La-Liga,2022/05/06,2022/05/07 15:15
11,Vallecano,34,11,8,15,35,39,17,8,5,4,23,13,17,3,3,11,12,26,41,-4,2.18,1.147058824,0.764705882,1.529411765,1.029411765,1.352941176,0.705882353,35.44117647,29.11764706,35.44117647,38,89.5,0.55,Spain-La-Liga,2022/05/06,2022/05/08 13:00
12,Celta Vigo,34,10,10,14,37,38,17,5,4,8,21,23,17,5,6,6,16,15,40,-1,2.21,1.117647059,1.352941176,0.882352941,1.088235294,1.235294118,0.941176471,35.44117647,29.11764706,35.44117647,38,89.5,0.6,Spain-La-Liga,2022/05/06,2022/05/07 17:30
12,Celta Vigo,34,10,10,14,37,38,17,5,4,8,21,23,17,5,6,6,16,15,40,-1,2.21,1.117647059,1.352941176,0.882352941,1.088235294,1.235294118,0.941176471,35.44117647,29.11764706,35.44117647,38,89.5,0.6,Spain-La-Liga,2022/05/06,2022/05/10 20:30
13,Elche,34,10,9,15,37,45,17,6,6,5,21,18,17,4,3,10,16,27,39,-8,2.41,1.323529412,1.058823529,1.588235294,1.088235294,1.235294118,0.941176471,35.44117647,29.11764706,35.44117647,38,89.5,0.65,Spain-La-Liga,2022/05/06,2022/05/07 17:30
14,Espanyol,34,10,9,15,37,49,17,9,4,4,23,17,17,1,5,11,14,32,39,-12,2.53,1.441176471,1,1.882352941,1.088235294,1.352941176,0.823529412,35.44117647,29.11764706,35.44117647,38,89.5,0.7,Spain-La-Liga,2022/05/06,2022/05/08 17:30
15,Getafe,34,8,12,14,31,37,17,7,5,5,21,15,17,1,7,9,10,22,36,-6,2,1.088235294,0.882352941,1.294117647,0.911764706,1.235294118,0.588235294,35.44117647,29.11764706,35.44117647,38,89.5,0.75,Spain-La-Liga,2022/05/06,2022/05/02 20:00
15,Getafe,34,8,12,14,31,37,17,7,5,5,21,15,17,1,7,9,10,22,36,-6,2,1.088235294,0.882352941,1.294117647,0.911764706,1.235294118,0.588235294,35.44117647,29.11764706,35.44117647,38,89.5,0.75,Spain-La-Liga,2022/05/06,2022/05/08 13:00
16,Cadiz,34,6,14,14,30,47,17,2,8,7,15,23,17,4,6,7,15,24,32,-17,2.26,1.382352941,1.352941176,1.411764706,0.882352941,0.882352941,0.882352941,35.44117647,29.11764706,35.44117647,38,89.5,0.8,Spain-La-Liga,2022/05/06,2022/05/07 17:30
17,Mallorca,34,8,8,18,30,56,17,6,6,5,16,18,17,2,2,13,14,38,32,-26,2.53,1.647058824,1.058823529,2.235294118,0.882352941,0.941176471,0.823529412,35.44117647,29.11764706,35.44117647,38,89.5,0.85,Spain-La-Liga,2022/05/06,2022/05/07 13:00
17,Mallorca,34,8,8,18,30,56,17,6,6,5,16,18,17,2,2,13,14,38,32,-26,2.53,1.647058824,1.058823529,2.235294118,0.882352941,0.941176471,0.823529412,35.44117647,29.11764706,35.44117647,38,89.5,0.85,Spain-La-Liga,2022/05/06,2022/05/01 20:00
18,Granada CF,34,6,13,15,37,57,17,4,6,7,21,29,17,2,7,8,16,28,31,-20,2.76,1.676470588,1.705882353,1.647058824,1.088235294,1.235294118,0.941176471,35.44117647,29.11764706,35.44117647,38,89.5,0.9,Spain-La-Liga,2022/05/06,2022/05/10 19:00
18,Granada CF,34,6,13,15,37,57,17,4,6,7,21,29,17,2,7,8,16,28,31,-20,2.76,1.676470588,1.705882353,1.647058824,1.088235294,1.235294118,0.941176471,35.44117647,29.11764706,35.44117647,38,89.5,0.9,Spain-La-Liga,2022/05/06,2022/05/07 13:00
19,Alaves,34,7,7,20,28,56,17,6,4,7,15,19,17,1,3,13,13,37,28,-28,2.47,1.647058824,1.117647059,2.176470588,0.823529412,0.882352941,0.764705882,35.44117647,29.11764706,35.44117647,38,89.5,0.95,Spain-La-Liga,2022/05/06,2022/05/07 17:30
20,Levante,34,5,11,18,42,66,17,3,7,7,23,28,17,2,4,11,19,38,26,-24,3.18,1.941176471,1.647058824,2.235294118,1.235294118,1.352941176,1.117647059,35.44117647,29.11764706,35.44117647,38,89.5,1,Spain-La-Liga,2022/05/06,2022/05/06 20:00
1,Bayern Munich,32,24,3,5,93,33,16,13,1,2,46,13,16,11,2,3,47,20,75,60,3.94,1.03125,0.8125,1.25,2.90625,2.875,2.9375,38.1533101,23.69337979,38.1533101,34,94.1,0.055555556,Germany-Bundesliga,2022/05/06,2022/05/08 16:30
2,Dortmund,32,20,3,9,80,50,16,12,0,4,50,27,16,8,3,5,30,23,63,30,4.06,1.5625,1.6875,1.4375,2.5,3.125,1.875,38.1533101,23.69337979,38.1533101,34,94.1,0.111111111,Germany-Bundesliga,2022/05/06,2022/04/30 14:30
2,Dortmund,32,20,3,9,80,50,16,12,0,4,50,27,16,8,3,5,30,23,63,30,4.06,1.5625,1.6875,1.4375,2.5,3.125,1.875,38.1533101,23.69337979,38.1533101,34,94.1,0.111111111,Germany-Bundesliga,2022/05/06,2022/05/07 14:30
3,Leverkusen,32,17,7,8,74,44,16,9,2,5,37,22,16,8,5,3,37,22,58,30,3.69,1.375,1.375,1.375,2.3125,2.3125,2.3125,38.1533101,23.69337979,38.1533101,34,94.1,0.166666667,Germany-Bundesliga,2022/05/06,2022/05/02 19:30
3,Leverkusen,32,17,7,8,74,44,16,9,2,5,37,22,16,8,5,3,37,22,58,30,3.69,1.375,1.375,1.375,2.3125,2.3125,2.3125,38.1533101,23.69337979,38.1533101,34,94.1,0.166666667,Germany-Bundesliga,2022/05/06,2022/05/07 14:30
4,SC Freiburg,32,15,10,7,56,40,16,8,5,3,31,21,16,7,5,4,25,19,55,16,3,1.25,1.3125,1.1875,1.75,1.9375,1.5625,38.1533101,23.69337979,38.1533101,34,94.1,0.222222222,Germany-Bundesliga,2022/05/06,2022/05/07 14:30
4,SC Freiburg,32,15,10,7,56,40,16,8,5,3,31,21,16,7,5,4,25,19,55,16,3,1.25,1.3125,1.1875,1.75,1.9375,1.5625,38.1533101,23.69337979,38.1533101,34,94.1,0.222222222,Germany-Bundesliga,2022/05/06,2022/04/30 17:30
5,RB Leipzig,32,16,6,10,67,36,16,10,2,4,39,17,16,6,4,6,28,19,54,31,3.22,1.125,1.0625,1.1875,2.09375,2.4375,1.75,38.1533101,23.69337979,38.1533101,34,94.1,0.277777778,Germany-Bundesliga,2022/05/06,2022/05/08 18:30
5,RB Leipzig,32,16,6,10,67,36,16,10,2,4,39,17,16,6,4,6,28,19,54,31,3.22,1.125,1.0625,1.1875,2.09375,2.4375,1.75,38.1533101,23.69337979,38.1533101,34,94.1,0.277777778,Germany-Bundesliga,2022/05/06,2022/05/02 19:30
6,1 FC Koln,32,14,10,8,51,46,16,9,4,3,27,20,16,5,6,5,24,26,52,5,3.03,1.4375,1.25,1.625,1.59375,1.6875,1.5,38.1533101,23.69337979,38.1533101,34,94.1,0.333333333,Germany-Bundesliga,2022/05/06,2022/05/07 14:30
6,1 FC Koln,32,14,10,8,51,46,16,9,4,3,27,20,16,5,6,5,24,26,52,5,3.03,1.4375,1.25,1.625,1.59375,1.6875,1.5,38.1533101,23.69337979,38.1533101,34,94.1,0.333333333,Germany-Bundesliga,2022/05/06,2022/04/30 14:30
7,Union Berlin,32,14,9,9,43,41,16,9,5,2,22,15,16,5,4,7,21,26,51,2,2.62,1.28125,0.9375,1.625,1.34375,1.375,1.3125,38.1533101,23.69337979,38.1533101,34,94.1,0.388888889,Germany-Bundesliga,2022/05/06,2022/05/07 14:30
8,Hoffenheim,32,13,7,12,55,51,16,8,4,4,32,20,16,5,3,8,23,31,46,4,3.31,1.59375,1.25,1.9375,1.71875,2,1.4375,38.1533101,23.69337979,38.1533101,34,94.1,0.444444444,Germany-Bundesliga,2022/05/06,2022/04/30 17:30
8,Hoffenheim,32,13,7,12,55,51,16,8,4,4,32,20,16,5,3,8,23,31,46,4,3.31,1.59375,1.25,1.9375,1.71875,2,1.4375,38.1533101,23.69337979,38.1533101,34,94.1,0.444444444,Germany-Bundesliga,2022/05/06,2022/05/07 14:30
9,Mainz,32,12,6,14,46,42,16,10,4,2,31,9,16,2,2,12,15,33,42,4,2.75,1.3125,0.5625,2.0625,1.4375,1.9375,0.9375,38.1533101,23.69337979,38.1533101,34,94.1,0.5,Germany-Bundesliga,2022/05/06,2022/05/07 17:30
10,Frankfurt,32,10,10,12,42,46,16,4,6,6,19,21,16,6,4,6,23,25,40,-4,2.75,1.4375,1.3125,1.5625,1.3125,1.1875,1.4375,38.1533101,23.69337979,38.1533101,34,94.1,0.555555556,Germany-Bundesliga,2022/05/06,2022/05/08 14:30
10,Frankfurt,32,10,10,12,42,46,16,4,6,6,19,21,16,6,4,6,23,25,40,-4,2.75,1.4375,1.3125,1.5625,1.3125,1.1875,1.4375,38.1533101,23.69337979,38.1533101,34,94.1,0.555555556,Germany-Bundesliga,2022/05/06,2022/05/02 19:30
11,VfL Bochum,31,11,6,14,34,46,15,7,4,4,19,14,16,4,2,10,15,32,39,-12,2.58,1.483870968,0.933333333,2,1.096774194,1.266666667,0.9375,38.1533101,23.69337979,38.1533101,34,91.2,0.611111111,Germany-Bundesliga,2022/05/06,2022/05/06 19:30
11,VfL Bochum,31,11,6,14,34,46,15,7,4,4,19,14,16,4,2,10,15,32,39,-12,2.58,1.483870968,0.933333333,2,1.096774194,1.266666667,0.9375,38.1533101,23.69337979,38.1533101,34,91.2,0.611111111,Germany-Bundesliga,2022/05/06,2022/04/30 14:30
12,Wolfsburg,32,11,5,16,41,52,16,7,2,7,23,19,16,4,3,9,18,33,38,-11,2.91,1.625,1.1875,2.0625,1.28125,1.4375,1.125,38.1533101,23.69337979,38.1533101,34,94.1,0.666666667,Germany-Bundesliga,2022/05/06,2022/05/07 14:30
13,Bor Mnchglbh,31,10,8,13,46,59,16,7,4,5,28,26,15,3,4,8,18,33,38,-13,3.39,1.903225806,1.625,2.2,1.483870968,1.75,1.2,38.1533101,23.69337979,38.1533101,34,91.2,0.722222222,Germany-Bundesliga,2022/05/06,2022/05/02 19:30
13,Bor Mnchglbh,31,10,8,13,46,59,16,7,4,5,28,26,15,3,4,8,18,33,38,-13,3.39,1.903225806,1.625,2.2,1.483870968,1.75,1.2,38.1533101,23.69337979,38.1533101,34,91.2,0.722222222,Germany-Bundesliga,2022/05/06,2022/05/08 14:30
14,Augsburg,32,9,8,15,37,51,16,6,4,6,23,25,16,3,4,9,14,26,35,-14,2.75,1.59375,1.5625,1.625,1.15625,1.4375,0.875,38.1533101,23.69337979,38.1533101,34,94.1,0.777777778,Germany-Bundesliga,2022/05/06,2022/04/30 14:30
14,Augsburg,32,9,8,15,37,51,16,6,4,6,23,25,16,3,4,9,14,26,35,-14,2.75,1.59375,1.5625,1.625,1.15625,1.4375,0.875,38.1533101,23.69337979,38.1533101,34,94.1,0.777777778,Germany-Bundesliga,2022/05/06,2022/05/08 18:30
15,Hertha Berlin,32,9,6,17,35,67,16,6,3,7,23,31,16,3,3,10,12,36,33,-32,3.19,2.09375,1.9375,2.25,1.09375,1.4375,0.75,38.1533101,23.69337979,38.1533101,34,94.1,0.833333333,Germany-Bundesliga,2022/05/06,2022/05/07 17:30
15,Hertha Berlin,32,9,6,17,35,67,16,6,3,7,23,31,16,3,3,10,12,36,33,-32,3.19,2.09375,1.9375,2.25,1.09375,1.4375,0.75,38.1533101,23.69337979,38.1533101,34,94.1,0.833333333,Germany-Bundesliga,2022/05/06,2022/04/30 14:30
16,Stuttgart,32,6,11,15,37,56,16,5,4,7,26,31,16,1,7,8,11,25,29,-19,2.91,1.75,1.9375,1.5625,1.15625,1.625,0.6875,38.1533101,23.69337979,38.1533101,34,94.1,0.888888889,Germany-Bundesliga,2022/05/06,2022/05/08 16:30
17,Bielefeld,32,5,12,15,25,50,16,2,9,5,14,22,16,3,3,10,11,28,27,-25,2.34,1.5625,1.375,1.75,0.78125,0.875,0.6875,38.1533101,23.69337979,38.1533101,34,94.1,0.944444444,Germany-Bundesliga,2022/05/06,2022/04/30 14:30
17,Bielefeld,32,5,12,15,25,50,16,2,9,5,14,22,16,3,3,10,11,28,27,-25,2.34,1.5625,1.375,1.75,0.78125,0.875,0.6875,38.1533101,23.69337979,38.1533101,34,94.1,0.944444444,Germany-Bundesliga,2022/05/06,2022/05/06 19:30
18,Greu Fuerth,32,3,9,20,26,78,16,3,5,8,14,31,16,0,4,12,12,47,18,-52,3.25,2.4375,1.9375,2.9375,0.8125,0.875,0.75,38.1533101,23.69337979,38.1533101,34,94.1,1,Germany-Bundesliga,2022/05/06,2022/05/07 14:30
1,Paris SG,35,24,7,4,79,34,17,15,2,0,42,10,18,9,5,4,37,24,79,45,3.23,0.971428571,0.588235294,1.333333333,2.257142857,2.470588235,2.055555556,36.28571429,27.42857143,36.28571429,38,92.1,0.05,France-Ligue-1,2022/05/06,2022/05/08 19:45
2,Marseille,35,19,8,8,56,36,18,8,5,5,29,22,17,11,3,3,27,14,65,20,2.63,1.028571429,1.222222222,0.823529412,1.6,1.611111111,1.588235294,36.28571429,27.42857143,36.28571429,38,92.1,0.1,France-Ligue-1,2022/05/06,2022/05/01 19:45
2,Marseille,35,19,8,8,56,36,18,8,5,5,29,22,17,11,3,3,27,14,65,20,2.63,1.028571429,1.222222222,0.823529412,1.6,1.611111111,1.588235294,36.28571429,27.42857143,36.28571429,38,92.1,0.1,France-Ligue-1,2022/05/06,2022/05/08 16:05
3,Rennes,35,19,5,11,77,36,18,13,1,4,48,13,17,6,4,7,29,23,62,41,3.23,1.028571429,0.722222222,1.352941176,2.2,2.666666667,1.705882353,36.28571429,27.42857143,36.28571429,38,92.1,0.15,France-Ligue-1,2022/05/06,
4,Monaco,35,18,8,9,57,35,18,11,4,3,34,14,17,7,4,6,23,21,62,22,2.63,1,0.777777778,1.235294118,1.628571429,1.888888889,1.352941176,36.28571429,27.42857143,36.28571429,38,92.1,0.2,France-Ligue-1,2022/05/06,2022/05/01 14:00
4,Monaco,35,18,8,9,57,35,18,11,4,3,34,14,17,7,4,6,23,21,62,22,2.63,1,0.777777778,1.235294118,1.628571429,1.888888889,1.352941176,36.28571429,27.42857143,36.28571429,38,92.1,0.2,France-Ligue-1,2022/05/06,2022/05/06 20:00
5,Nice,35,18,7,10,44,29,17,9,4,4,22,16,18,9,3,6,22,13,61,15,2.09,0.828571429,0.941176471,0.722222222,1.257142857,1.294117647,1.222222222,36.28571429,27.42857143,36.28571429,38,92.1,0.25,France-Ligue-1,2022/05/06,2022/05/01 16:05
6,Strasbourg,35,15,12,8,58,39,18,10,5,3,35,18,17,5,7,5,23,21,57,19,2.77,1.114285714,1,1.235294118,1.657142857,1.944444444,1.352941176,36.28571429,27.42857143,36.28571429,38,92.1,0.3,France-Ligue-1,2022/05/06,2022/05/07 16:00
7,Lyon,35,15,11,9,59,45,18,10,5,3,39,23,17,5,6,6,20,22,56,14,2.97,1.285714286,1.277777778,1.294117647,1.685714286,2.166666667,1.176470588,36.28571429,27.42857143,36.28571429,38,92.1,0.35,France-Ligue-1,2022/05/06,2022/05/01 19:45
7,Lyon,35,15,11,9,59,45,18,10,5,3,39,23,17,5,6,6,20,22,56,14,2.97,1.285714286,1.277777778,1.294117647,1.685714286,2.166666667,1.176470588,36.28571429,27.42857143,36.28571429,38,92.1,0.35,France-Ligue-1,2022/05/06,2022/05/08 12:00
8,Lens,35,15,10,10,55,44,18,9,6,3,33,18,17,6,4,7,22,26,55,11,2.83,1.257142857,1,1.529411765,1.571428571,1.833333333,1.294117647,36.28571429,27.42857143,36.28571429,38,92.1,0.4,France-Ligue-1,2022/05/06,2022/05/08 14:00
9,Nantes,35,14,9,12,50,43,17,10,3,4,30,18,18,4,6,8,20,25,51,7,2.66,1.228571429,1.058823529,1.388888889,1.428571429,1.764705882,1.111111111,36.28571429,27.42857143,36.28571429,38,92.1,0.45,France-Ligue-1,2022/05/06,
10,Lille,35,13,12,10,42,43,17,7,7,3,21,18,18,6,5,7,21,25,51,-1,2.43,1.228571429,1.058823529,1.388888889,1.2,1.235294118,1.166666667,36.28571429,27.42857143,36.28571429,38,92.1,0.5,France-Ligue-1,2022/05/06,2022/05/06 20:00
10,Lille,35,13,12,10,42,43,17,7,7,3,21,18,18,6,5,7,21,25,51,-1,2.43,1.228571429,1.058823529,1.388888889,1.2,1.235294118,1.166666667,36.28571429,27.42857143,36.28571429,38,92.1,0.5,France-Ligue-1,2022/05/06,2022/05/01 12:00
11,Brest,35,13,9,13,45,48,17,7,4,6,26,24,18,6,5,7,19,24,48,-3,2.66,1.371428571,1.411764706,1.333333333,1.285714286,1.529411765,1.055555556,36.28571429,27.42857143,36.28571429,38,92.1,0.55,France-Ligue-1,2022/05/06,2022/05/01 14:00
11,Brest,35,13,9,13,45,48,17,7,4,6,26,24,18,6,5,7,19,24,48,-3,2.66,1.371428571,1.411764706,1.333333333,1.285714286,1.529411765,1.055555556,36.28571429,27.42857143,36.28571429,38,92.1,0.55,France-Ligue-1,2022/05/06,2022/05/07 16:00
12,Reims,35,10,13,12,38,38,17,5,6,6,22,18,18,5,7,6,16,20,43,0,2.17,1.085714286,1.058823529,1.111111111,1.085714286,1.294117647,0.888888889,36.28571429,27.42857143,36.28571429,38,92.1,0.6,France-Ligue-1,2022/05/06,2022/05/08 14:00
12,Reims,35,10,13,12,38,38,17,5,6,6,22,18,18,5,7,6,16,20,43,0,2.17,1.085714286,1.058823529,1.111111111,1.085714286,1.294117647,0.888888889,36.28571429,27.42857143,36.28571429,38,92.1,0.6,France-Ligue-1,2022/05/06,2022/05/01 14:00
13,Montpellier,35,12,7,16,48,53,18,7,5,6,27,22,17,5,2,10,21,31,43,-5,2.89,1.514285714,1.222222222,1.823529412,1.371428571,1.5,1.235294118,36.28571429,27.42857143,36.28571429,38,92.1,0.65,France-Ligue-1,2022/05/06,2022/05/01 14:00
13,Montpellier,35,12,7,16,48,53,18,7,5,6,27,22,17,5,2,10,21,31,43,-5,2.89,1.514285714,1.222222222,1.823529412,1.371428571,1.5,1.235294118,36.28571429,27.42857143,36.28571429,38,92.1,0.65,France-Ligue-1,2022/05/06,2022/05/08 14:00
14,Troyes,35,9,9,17,33,47,18,5,7,6,18,16,17,4,2,11,15,31,36,-14,2.29,1.342857143,0.888888889,1.823529412,0.942857143,1,0.882352941,36.28571429,27.42857143,36.28571429,38,92.1,0.7,France-Ligue-1,2022/05/06,2022/05/01 12:00
14,Troyes,35,9,9,17,33,47,18,5,7,6,18,16,17,4,2,11,15,31,36,-14,2.29,1.342857143,0.888888889,1.823529412,0.942857143,1,0.882352941,36.28571429,27.42857143,36.28571429,38,92.1,0.7,France-Ligue-1,2022/05/06,2022/05/08 19:45
15,Angers,35,8,11,16,38,53,17,6,2,9,17,22,18,2,9,7,21,31,35,-15,2.6,1.514285714,1.294117647,1.722222222,1.085714286,1,1.166666667,36.28571429,27.42857143,36.28571429,38,92.1,0.75,France-Ligue-1,2022/05/06,2022/05/08 14:00
15,Angers,35,8,11,16,38,53,17,6,2,9,17,22,18,2,9,7,21,31,35,-15,2.6,1.514285714,1.294117647,1.722222222,1.085714286,1,1.166666667,36.28571429,27.42857143,36.28571429,38,92.1,0.75,France-Ligue-1,2022/05/06,2022/05/01 14:00
16,Lorient,35,8,10,17,34,59,17,6,5,6,19,18,18,2,5,11,15,41,34,-25,2.66,1.685714286,1.058823529,2.277777778,0.971428571,1.117647059,0.833333333,36.28571429,27.42857143,36.28571429,38,92.1,0.8,France-Ligue-1,2022/05/06,2022/05/01 14:00
16,Lorient,35,8,10,17,34,59,17,6,5,6,19,18,18,2,5,11,15,41,34,-25,2.66,1.685714286,1.058823529,2.277777778,0.971428571,1.117647059,0.833333333,36.28571429,27.42857143,36.28571429,38,92.1,0.8,France-Ligue-1,2022/05/06,2022/05/08 16:05
17,Clermont,35,8,9,18,35,65,17,3,6,8,19,30,18,5,3,10,16,35,33,-30,2.86,1.857142857,1.764705882,1.944444444,1,1.117647059,0.888888889,36.28571429,27.42857143,36.28571429,38,92.1,0.85,France-Ligue-1,2022/05/06,2022/05/08 14:00
17,Clermont,35,8,9,18,35,65,17,3,6,8,19,30,18,5,3,10,16,35,33,-30,2.86,1.857142857,1.764705882,1.944444444,1,1.117647059,0.888888889,36.28571429,27.42857143,36.28571429,38,92.1,0.85,France-Ligue-1,2022/05/06,2022/05/01 14:00
18,St Etienne,35,7,10,18,38,70,18,4,6,8,23,36,17,3,4,10,15,34,31,-32,3.09,2,2,2,1.085714286,1.277777778,0.882352941,36.28571429,27.42857143,36.28571429,38,92.1,0.9,France-Ligue-1,2022/05/06,
19,Bordeaux,35,5,12,18,47,85,18,3,6,9,25,33,17,2,6,9,22,52,27,-38,3.77,2.428571429,1.833333333,3.058823529,1.342857143,1.388888889,1.294117647,36.28571429,27.42857143,36.28571429,38,92.1,0.95,France-Ligue-1,2022/05/06,2022/05/01 16:05
19,Bordeaux,35,5,12,18,47,85,18,3,6,9,25,33,17,2,6,9,22,52,27,-38,3.77,2.428571429,1.833333333,3.058823529,1.342857143,1.388888889,1.294117647,36.28571429,27.42857143,36.28571429,38,92.1,0.95,France-Ligue-1,2022/05/06,2022/05/08 14:00
20,Metz,35,4,13,18,31,62,17,1,7,9,17,29,18,3,6,9,14,33,25,-31,2.66,1.771428571,1.705882353,1.833333333,0.885714286,1,0.777777778,36.28571429,27.42857143,36.28571429,38,92.1,1,France-Ligue-1,2022/05/06,2022/05/08 12:00
20,Metz,35,4,13,18,31,62,17,1,7,9,17,29,18,3,6,9,14,33,25,-31,2.66,1.771428571,1.705882353,1.833333333,0.885714286,1,0.777777778,36.28571429,27.42857143,36.28571429,38,92.1,1,France-Ligue-1,2022/05/06,2022/05/01 14:00
1,AC Milan,35,23,8,4,61,30,18,11,4,3,26,12,17,12,4,1,35,18,77,31,2.6,0.857142857,0.666666667,1.058823529,1.742857143,1.444444444,2.058823529,37,26,37,38,92.1,0.05,Italy-Serie-A,2022/05/06,2022/05/01 14:00
1,AC Milan,35,23,8,4,61,30,18,11,4,3,26,12,17,12,4,1,35,18,77,31,2.6,0.857142857,0.666666667,1.058823529,1.742857143,1.444444444,2.058823529,37,26,37,38,92.1,0.05,Italy-Serie-A,2022/05/06,2022/05/08 19:45
2,Inter Milan,35,22,9,4,74,29,17,12,3,2,41,14,18,10,6,2,33,15,75,45,2.94,0.828571429,0.823529412,0.833333333,2.114285714,2.411764706,1.833333333,37,26,37,38,92.1,0.1,Italy-Serie-A,2022/05/06,2022/05/06 17:45
2,Inter Milan,35,22,9,4,74,29,17,12,3,2,41,14,18,10,6,2,33,15,75,45,2.94,0.828571429,0.823529412,0.833333333,2.114285714,2.411764706,1.833333333,37,26,37,38,92.1,0.1,Italy-Serie-A,2022/05/06,2022/05/01 17:00
3,Napoli,35,21,7,7,67,31,18,10,3,5,34,16,17,11,4,2,33,15,70,36,2.8,0.885714286,0.888888889,0.882352941,1.914285714,1.888888889,1.941176471,37,26,37,38,92.1,0.15,Italy-Serie-A,2022/05/06,2022/05/07 14:00
4,Juventus,35,20,9,6,54,31,18,10,4,4,23,12,17,10,5,2,31,19,69,23,2.43,0.885714286,0.666666667,1.117647059,1.542857143,1.277777778,1.823529412,37,26,37,38,92.1,0.2,Italy-Serie-A,2022/05/06,2022/05/06 20:00
5,Lazio,35,17,8,10,70,53,17,9,5,3,37,22,18,8,3,7,33,31,59,17,3.51,1.514285714,1.294117647,1.722222222,2,2.176470588,1.833333333,37,26,37,38,92.1,0.25,Italy-Serie-A,2022/05/06,2022/05/07 19:45
6,Roma,35,17,8,10,55,40,18,10,5,3,25,15,17,7,3,7,30,25,59,15,2.71,1.142857143,0.833333333,1.470588235,1.571428571,1.388888889,1.764705882,37,26,37,38,92.1,0.3,Italy-Serie-A,2022/05/06,2022/05/01 19:45
6,Roma,35,17,8,10,55,40,18,10,5,3,25,15,17,7,3,7,30,25,59,15,2.71,1.142857143,0.833333333,1.470588235,1.571428571,1.388888889,1.764705882,37,26,37,38,92.1,0.3,Italy-Serie-A,2022/05/06,2022/05/09 19:45
7,Atalanta,35,15,11,9,62,44,18,4,8,6,31,28,17,11,3,3,31,16,56,18,3.03,1.257142857,1.555555556,0.941176471,1.771428571,1.722222222,1.823529412,37,26,37,38,92.1,0.35,Italy-Serie-A,2022/05/06,2022/05/02 19:45
7,Atalanta,35,15,11,9,62,44,18,4,8,6,31,28,17,11,3,3,31,16,56,18,3.03,1.257142857,1.555555556,0.941176471,1.771428571,1.722222222,1.823529412,37,26,37,38,92.1,0.35,Italy-Serie-A,2022/05/06,2022/05/08 11:30
8,Fiorentina,35,17,5,13,54,47,17,11,2,4,34,20,18,6,3,9,20,27,56,7,2.89,1.342857143,1.176470588,1.5,1.542857143,2,1.111111111,37,26,37,38,92.1,0.4,Italy-Serie-A,2022/05/06,2022/05/09 19:45
8,Fiorentina,35,17,5,13,54,47,17,11,2,4,34,20,18,6,3,9,20,27,56,7,2.89,1.342857143,1.176470588,1.5,1.542857143,2,1.111111111,37,26,37,38,92.1,0.4,Italy-Serie-A,2022/05/06,2022/05/01 14:00
9,Verona,35,14,10,11,61,52,17,9,3,5,33,21,18,5,7,6,28,31,52,9,3.23,1.485714286,1.235294118,1.722222222,1.742857143,1.941176471,1.555555556,37,26,37,38,92.1,0.45,Italy-Serie-A,2022/05/06,2022/05/08 19:45
10,Torino,35,12,11,12,45,37,17,8,5,4,29,17,18,4,6,8,16,20,47,8,2.34,1.057142857,1,1.111111111,1.285714286,1.705882353,0.888888889,37,26,37,38,92.1,0.5,Italy-Serie-A,2022/05/06,2022/05/07 14:00
11,Sassuolo,35,12,10,13,60,61,17,6,5,6,26,26,18,6,5,7,34,35,46,-1,3.46,1.742857143,1.529411765,1.944444444,1.714285714,1.529411765,1.888888889,37,26,37,38,92.1,0.55,Italy-Serie-A,2022/05/06,2022/05/07 17:00
12,Udinese,35,10,13,12,54,54,18,6,7,5,29,26,17,4,6,7,25,28,43,0,3.09,1.542857143,1.444444444,1.647058824,1.542857143,1.611111111,1.470588235,37,26,37,38,92.1,0.6,Italy-Serie-A,2022/05/06,2022/05/01 17:00
12,Udinese,35,10,13,12,54,54,18,6,7,5,29,26,17,4,6,7,25,28,43,0,3.09,1.542857143,1.444444444,1.647058824,1.542857143,1.611111111,1.470588235,37,26,37,38,92.1,0.6,Italy-Serie-A,2022/05/06,2022/05/07 17:00
13,Bologna,35,11,10,14,39,48,18,8,4,6,24,21,17,3,6,8,15,27,43,-9,2.49,1.371428571,1.166666667,1.588235294,1.114285714,1.333333333,0.882352941,37,26,37,38,92.1,0.65,Italy-Serie-A,2022/05/06,2022/05/01 19:45
13,Bologna,35,11,10,14,39,48,18,8,4,6,24,21,17,3,6,8,15,27,43,-9,2.49,1.371428571,1.166666667,1.588235294,1.114285714,1.333333333,0.882352941,37,26,37,38,92.1,0.65,Italy-Serie-A,2022/05/06,2022/05/08 14:00
14,Empoli,35,9,10,16,46,65,18,4,4,10,27,43,17,5,6,6,19,22,37,-19,3.17,1.857142857,2.388888889,1.294117647,1.314285714,1.5,1.117647059,37,26,37,38,92.1,0.7,Italy-Serie-A,2022/05/06,2022/05/06 17:45
15,Sampdoria,35,9,6,20,42,57,18,5,3,10,25,31,17,4,3,10,17,26,33,-15,2.83,1.628571429,1.722222222,1.529411765,1.2,1.388888889,1,37,26,37,38,92.1,0.75,Italy-Serie-A,2022/05/06,2022/05/07 19:45
16,Spezia,35,9,6,20,37,63,17,5,3,9,20,24,18,4,3,11,17,39,33,-26,2.86,1.8,1.411764706,2.166666667,1.057142857,1.176470588,0.944444444,37,26,37,38,92.1,0.8,Italy-Serie-A,2022/05/06,2022/05/08 11:30
17,Salernitana,35,7,8,20,31,72,17,3,5,9,16,34,18,4,3,11,15,38,29,-41,2.94,2.057142857,2,2.111111111,0.885714286,0.941176471,0.833333333,37,26,37,38,92.1,0.85,Italy-Serie-A,2022/05/06,2022/05/05 17:00
17,Salernitana,35,7,8,20,31,72,17,3,5,9,16,34,18,4,3,11,15,38,29,-41,2.94,2.057142857,2,2.111111111,0.885714286,0.941176471,0.833333333,37,26,37,38,92.1,0.85,Italy-Serie-A,2022/05/06,2022/05/08 17:00
17,Salernitana,35,7,8,20,31,72,17,3,5,9,16,34,18,4,3,11,15,38,29,-41,2.94,2.057142857,2,2.111111111,0.885714286,0.941176471,0.833333333,37,26,37,38,92.1,0.85,Italy-Serie-A,2022/05/06,2022/05/02 19:45
18,Cagliari,35,6,10,19,32,64,18,3,6,9,19,30,17,3,4,10,13,34,28,-32,2.74,1.828571429,1.666666667,2,0.914285714,1.055555556,0.764705882,37,26,37,38,92.1,0.9,Italy-Serie-A,2022/05/06,2022/05/08 17:00
19,Genoa,35,3,16,16,25,55,17,2,8,7,12,23,18,1,8,9,13,32,25,-30,2.29,1.571428571,1.352941176,1.777777778,0.714285714,0.705882353,0.722222222,37,26,37,38,92.1,0.95,Italy-Serie-A,2022/05/06,2022/05/06 20:00
20,Venezia,35,5,7,23,29,65,17,2,4,11,17,35,18,3,3,12,12,30,22,-36,2.69,1.857142857,2.058823529,1.666666667,0.828571429,1,0.666666667,37,26,37,38,92.1,1,Italy-Serie-A,2022/05/06,2022/05/08 14:00
20,Venezia,35,5,7,23,29,65,17,2,4,11,17,35,18,3,3,12,12,30,22,-36,2.69,1.857142857,2.058823529,1.666666667,0.828571429,1,0.666666667,37,26,37,38,92.1,1,Italy-Serie-A,2022/05/06,2022/05/05 17:00
1,Ajax,31,25,3,3,89,15,16,13,1,2,57,8,15,12,2,1,32,7,78,74,3.35,0.483870968,0.5,0.466666667,2.870967742,3.5625,2.133333333,39.78494624,20.43010753,39.78494624,34,91.2,0.055555556,Netherlands-Eredivisie,2022/05/06,2022/05/08 13:30
2,PSV,31,24,2,5,79,37,16,13,0,3,46,20,15,11,2,2,33,17,74,42,3.74,1.193548387,1.25,1.133333333,2.548387097,2.875,2.2,39.78494624,20.43010753,39.78494624,34,91.2,0.111111111,Netherlands-Eredivisie,2022/05/06,2022/05/01 13:30
2,PSV,31,24,2,5,79,37,16,13,0,3,46,20,15,11,2,2,33,17,74,42,3.74,1.193548387,1.25,1.133333333,2.548387097,2.875,2.2,39.78494624,20.43010753,39.78494624,34,91.2,0.111111111,Netherlands-Eredivisie,2022/05/06,2022/05/08 15:45
3,Feyenoord,31,21,4,6,72,30,15,11,2,2,36,13,16,10,2,4,36,17,67,42,3.29,0.967741935,0.866666667,1.0625,2.322580645,2.4,2.25,39.78494624,20.43010753,39.78494624,34,91.2,0.166666667,Netherlands-Eredivisie,2022/05/06,2022/05/08 15:45
3,Feyenoord,31,21,4,6,72,30,15,11,2,2,36,13,16,10,2,4,36,17,67,42,3.29,0.967741935,0.866666667,1.0625,2.322580645,2.4,2.25,39.78494624,20.43010753,39.78494624,34,91.2,0.166666667,Netherlands-Eredivisie,2022/05/06,2022/05/01 15:45
4,Twente,31,18,8,5,49,34,15,9,5,1,24,11,16,9,3,4,25,23,62,15,2.68,1.096774194,0.733333333,1.4375,1.580645161,1.6,1.5625,39.78494624,20.43010753,39.78494624,34,91.2,0.222222222,Netherlands-Eredivisie,2022/05/06,2022/05/07 17:45
5,AZ,31,18,5,8,59,37,15,11,2,2,33,15,16,7,3,6,26,22,59,22,3.1,1.193548387,1,1.375,1.903225806,2.2,1.625,39.78494624,20.43010753,39.78494624,34,91.2,0.277777778,Netherlands-Eredivisie,2022/05/06,2022/05/08 13:30
5,AZ,31,18,5,8,59,37,15,11,2,2,33,15,16,7,3,6,26,22,59,22,3.1,1.193548387,1,1.375,1.903225806,2.2,1.625,39.78494624,20.43010753,39.78494624,34,91.2,0.277777778,Netherlands-Eredivisie,2022/05/06,2022/04/30 20:00
6,Vitesse,31,14,5,12,37,46,15,6,2,7,17,25,16,8,3,5,20,21,47,-9,2.68,1.483870968,1.666666667,1.3125,1.193548387,1.133333333,1.25,39.78494624,20.43010753,39.78494624,34,91.2,0.333333333,Netherlands-Eredivisie,2022/05/06,2022/05/08 13:30
6,Vitesse,31,14,5,12,37,46,15,6,2,7,17,25,16,8,3,5,20,21,47,-9,2.68,1.483870968,1.666666667,1.3125,1.193548387,1.133333333,1.25,39.78494624,20.43010753,39.78494624,34,91.2,0.333333333,Netherlands-Eredivisie,2022/05/06,2022/05/01 13:30
7,Utrecht,31,12,9,10,48,40,16,8,5,3,30,18,15,4,4,7,18,22,45,8,2.84,1.290322581,1.125,1.466666667,1.548387097,1.875,1.2,39.78494624,20.43010753,39.78494624,34,91.2,0.388888889,Netherlands-Eredivisie,2022/05/06,2022/05/07 19:00
8,FC Groningen,31,9,9,13,38,47,15,4,6,5,15,16,16,5,3,8,23,31,36,-9,2.74,1.516129032,1.066666667,1.9375,1.225806452,1,1.4375,39.78494624,20.43010753,39.78494624,34,91.2,0.444444444,Netherlands-Eredivisie,2022/05/06,2022/05/07 20:00
8,FC Groningen,31,9,9,13,38,47,15,4,6,5,15,16,16,5,3,8,23,31,36,-9,2.74,1.516129032,1.066666667,1.9375,1.225806452,1,1.4375,39.78494624,20.43010753,39.78494624,34,91.2,0.444444444,Netherlands-Eredivisie,2022/05/06,2022/05/01 19:00
9,Go Ah Eagle,31,10,6,15,36,46,16,7,1,8,25,23,15,3,5,7,11,23,36,-10,2.65,1.483870968,1.4375,1.533333333,1.161290323,1.5625,0.733333333,39.78494624,20.43010753,39.78494624,34,91.2,0.5,Netherlands-Eredivisie,2022/05/06,2022/05/01 13:30
9,Go Ah Eagle,31,10,6,15,36,46,16,7,1,8,25,23,15,3,5,7,11,23,36,-10,2.65,1.483870968,1.4375,1.533333333,1.161290323,1.5625,0.733333333,39.78494624,20.43010753,39.78494624,34,91.2,0.5,Netherlands-Eredivisie,2022/05/06,2022/05/08 11:15
10,Heerenveen,31,9,8,14,32,43,16,5,3,8,20,25,15,4,5,6,12,18,35,-11,2.42,1.387096774,1.5625,1.2,1.032258065,1.25,0.8,39.78494624,20.43010753,39.78494624,34,91.2,0.555555556,Netherlands-Eredivisie,2022/05/06,2022/05/01 11:15
10,Heerenveen,31,9,8,14,32,43,16,5,3,8,20,25,15,4,5,6,12,18,35,-11,2.42,1.387096774,1.5625,1.2,1.032258065,1.25,0.8,39.78494624,20.43010753,39.78494624,34,91.2,0.555555556,Netherlands-Eredivisie,2022/05/06,2022/05/08 13:30
11,NEC,31,9,8,14,35,48,15,2,5,8,12,21,16,7,3,6,23,27,35,-13,2.68,1.548387097,1.4,1.6875,1.129032258,0.8,1.4375,39.78494624,20.43010753,39.78494624,34,91.2,0.611111111,Netherlands-Eredivisie,2022/05/06,2022/05/08 11:15
12,Heracles Alm,31,9,7,15,32,42,16,7,5,4,21,18,15,2,2,11,11,24,34,-10,2.39,1.35483871,1.125,1.6,1.032258065,1.3125,0.733333333,39.78494624,20.43010753,39.78494624,34,91.2,0.666666667,Netherlands-Eredivisie,2022/05/06,2022/05/07 19:00
13,Cambuur,31,10,4,17,48,66,15,5,1,9,27,33,16,5,3,8,21,33,34,-18,3.68,2.129032258,2.2,2.0625,1.548387097,1.8,1.3125,39.78494624,20.43010753,39.78494624,34,91.2,0.722222222,Netherlands-Eredivisie,2022/05/06,2022/05/06 19:00
13,Cambuur,31,10,4,17,48,66,15,5,1,9,27,33,16,5,3,8,21,33,34,-18,3.68,2.129032258,2.2,2.0625,1.548387097,1.8,1.3125,39.78494624,20.43010753,39.78494624,34,91.2,0.722222222,Netherlands-Eredivisie,2022/05/06,2022/05/01 11:15
14,RKC Waalwijk,31,7,10,14,34,49,16,5,3,8,15,25,15,2,7,6,19,24,31,-15,2.68,1.580645161,1.5625,1.6,1.096774194,0.9375,1.266666667,39.78494624,20.43010753,39.78494624,34,91.2,0.777777778,Netherlands-Eredivisie,2022/05/06,2022/05/01 19:00
14,RKC Waalwijk,31,7,10,14,34,49,16,5,3,8,15,25,15,2,7,6,19,24,31,-15,2.68,1.580645161,1.5625,1.6,1.096774194,0.9375,1.266666667,39.78494624,20.43010753,39.78494624,34,91.2,0.777777778,Netherlands-Eredivisie,2022/05/06,2022/05/06 19:00
15,Fortuna,31,8,5,18,32,64,16,6,2,8,19,29,15,2,3,10,13,35,29,-32,3.1,2.064516129,1.8125,2.333333333,1.032258065,1.1875,0.866666667,39.78494624,20.43010753,39.78494624,34,91.2,0.833333333,Netherlands-Eredivisie,2022/05/06,2022/05/01 15:45
15,Fortuna,31,8,5,18,32,64,16,6,2,8,19,29,15,2,3,10,13,35,29,-32,3.1,2.064516129,1.8125,2.333333333,1.032258065,1.1875,0.866666667,39.78494624,20.43010753,39.78494624,34,91.2,0.833333333,Netherlands-Eredivisie,2022/05/06,2022/05/07 17:45
16,FC Zwolle,31,7,5,19,24,47,15,3,4,8,11,17,16,4,1,11,13,30,26,-23,2.29,1.516129032,1.133333333,1.875,0.774193548,0.733333333,0.8125,39.78494624,20.43010753,39.78494624,34,91.2,0.888888889,Netherlands-Eredivisie,2022/05/06,2022/05/07 19:00
17,Sparta,31,5,11,15,23,46,16,3,7,6,14,21,15,2,4,9,9,25,26,-23,2.23,1.483870968,1.3125,1.666666667,0.741935484,0.875,0.6,39.78494624,20.43010753,39.78494624,34,91.2,0.944444444,Netherlands-Eredivisie,2022/05/06,2022/04/30 20:00
17,Sparta,31,5,11,15,23,46,16,3,7,6,14,21,15,2,4,9,9,25,26,-23,2.23,1.483870968,1.3125,1.666666667,0.741935484,0.875,0.6,39.78494624,20.43010753,39.78494624,34,91.2,0.944444444,Netherlands-Eredivisie,2022/05/06,2022/05/07 20:00
18,Willem II,31,7,5,19,26,56,15,5,3,7,13,20,16,2,2,12,13,36,26,-30,2.65,1.806451613,1.333333333,2.25,0.838709677,0.866666667,0.8125,39.78494624,20.43010753,39.78494624,34,91.2,1,Netherlands-Eredivisie,2022/05/06,2022/05/07 19:00
18,Willem II,31,7,5,19,26,56,15,5,3,7,13,20,16,2,2,12,13,36,26,-30,2.65,1.806451613,1.333333333,2.25,0.838709677,0.866666667,0.8125,39.78494624,20.43010753,39.78494624,34,91.2,1,Netherlands-Eredivisie,2022/05/06,2022/05/01 13:30
1,FC Porto,32,27,4,1,83,22,16,14,2,0,48,11,16,13,2,1,35,11,85,61,3.28,0.6875,0.6875,0.6875,2.59375,3,2.1875,35.54006969,28.91986063,35.54006969,34,94.1,0.055555556,Portugal-Primeira-Liga,2022/05/06,2022/04/30 19:00
1,FC Porto,32,27,4,1,83,22,16,14,2,0,48,11,16,13,2,1,35,11,85,61,3.28,0.6875,0.6875,0.6875,2.59375,3,2.1875,35.54006969,28.91986063,35.54006969,34,94.1,0.055555556,Portugal-Primeira-Liga,2022/05/06,2022/05/07 18:00
2,Sporting CP,32,25,4,3,66,21,16,13,1,2,30,8,16,12,3,1,36,13,79,45,2.72,0.65625,0.5,0.8125,2.0625,1.875,2.25,35.54006969,28.91986063,35.54006969,34,94.1,0.111111111,Portugal-Primeira-Liga,2022/05/06,2022/05/01 20:30
2,Sporting CP,32,25,4,3,66,21,16,13,1,2,30,8,16,12,3,1,36,13,79,45,2.72,0.65625,0.5,0.8125,2.0625,1.875,2.25,35.54006969,28.91986063,35.54006969,34,94.1,0.111111111,Portugal-Primeira-Liga,2022/05/06,2022/05/07 20:30
3,Benfica,31,21,5,5,69,29,16,10,3,3,36,15,15,11,2,2,33,14,68,40,3.16,0.935483871,0.9375,0.933333333,2.225806452,2.25,2.2,35.54006969,28.91986063,35.54006969,34,91.2,0.166666667,Portugal-Primeira-Liga,2022/05/06,2022/05/07 18:00
4,Braga,32,18,8,6,49,28,16,9,4,3,26,13,16,9,4,3,23,15,62,21,2.41,0.875,0.8125,0.9375,1.53125,1.625,1.4375,35.54006969,28.91986063,35.54006969,34,94.1,0.222222222,Portugal-Primeira-Liga,2022/05/06,2022/05/08 18:00
4,Braga,32,18,8,6,49,28,16,9,4,3,26,13,16,9,4,3,23,15,62,21,2.41,0.875,0.8125,0.9375,1.53125,1.625,1.4375,35.54006969,28.91986063,35.54006969,34,94.1,0.222222222,Portugal-Primeira-Liga,2022/05/06,2022/04/30 21:00
5,Gil Vicente,32,12,12,8,44,37,16,5,6,5,22,19,16,7,6,3,22,18,48,7,2.53,1.15625,1.1875,1.125,1.375,1.375,1.375,35.54006969,28.91986063,35.54006969,34,94.1,0.277777778,Portugal-Primeira-Liga,2022/05/06,2022/05/08 15:30
5,Gil Vicente,32,12,12,8,44,37,16,5,6,5,22,19,16,7,6,3,22,18,48,7,2.53,1.15625,1.1875,1.125,1.375,1.375,1.375,35.54006969,28.91986063,35.54006969,34,94.1,0.277777778,Portugal-Primeira-Liga,2022/05/06,2022/05/01 20:30
6,Guimaraes,32,12,8,12,44,40,16,8,3,5,29,20,16,4,5,7,15,20,44,4,2.62,1.25,1.25,1.25,1.375,1.8125,0.9375,35.54006969,28.91986063,35.54006969,34,94.1,0.333333333,Portugal-Primeira-Liga,2022/05/06,2022/05/01 15:30
6,Guimaraes,32,12,8,12,44,40,16,8,3,5,29,20,16,4,5,7,15,20,44,4,2.62,1.25,1.25,1.25,1.375,1.8125,0.9375,35.54006969,28.91986063,35.54006969,34,94.1,0.333333333,Portugal-Primeira-Liga,2022/05/06,2022/05/06 20:15
7,Ferreira,32,9,11,12,29,40,16,5,6,5,19,20,16,4,5,7,10,20,38,-11,2.16,1.25,1.25,1.25,0.90625,1.1875,0.625,35.54006969,28.91986063,35.54006969,34,94.1,0.388888889,Portugal-Primeira-Liga,2022/05/06,2022/05/02 20:15
7,Ferreira,32,9,11,12,29,40,16,5,6,5,19,20,16,4,5,7,10,20,38,-11,2.16,1.25,1.25,1.25,0.90625,1.1875,0.625,35.54006969,28.91986063,35.54006969,34,94.1,0.388888889,Portugal-Primeira-Liga,2022/05/06,2022/05/08 20:30
8,Maritimo,32,9,10,13,38,42,16,4,6,6,19,16,16,5,4,7,19,26,37,-4,2.5,1.3125,1,1.625,1.1875,1.1875,1.1875,35.54006969,28.91986063,35.54006969,34,94.1,0.444444444,Portugal-Primeira-Liga,2022/05/06,2022/05/08 15:30
9,Santa Clara,32,8,13,11,36,50,16,7,6,3,22,23,16,1,7,8,14,27,37,-14,2.69,1.5625,1.4375,1.6875,1.125,1.375,0.875,35.54006969,28.91986063,35.54006969,34,94.1,0.5,Portugal-Primeira-Liga,2022/05/06,2022/05/08 20:30
9,Santa Clara,32,8,13,11,36,50,16,7,6,3,22,23,16,1,7,8,14,27,37,-14,2.69,1.5625,1.4375,1.6875,1.125,1.375,0.875,35.54006969,28.91986063,35.54006969,34,94.1,0.5,Portugal-Primeira-Liga,2022/05/06,2022/05/01 15:30
10,Estoril,32,8,12,12,35,41,16,3,8,5,20,21,16,5,4,7,15,20,36,-6,2.38,1.28125,1.3125,1.25,1.09375,1.25,0.9375,35.54006969,28.91986063,35.54006969,34,94.1,0.555555556,Portugal-Primeira-Liga,2022/05/06,2022/05/07 15:30
11,Boavista,32,7,15,10,36,49,16,4,9,3,19,19,16,3,6,7,17,30,36,-13,2.66,1.53125,1.1875,1.875,1.125,1.1875,1.0625,35.54006969,28.91986063,35.54006969,34,94.1,0.611111111,Portugal-Primeira-Liga,2022/05/06,2022/05/06 20:15
11,Boavista,32,7,15,10,36,49,16,4,9,3,19,19,16,3,6,7,17,30,36,-13,2.66,1.53125,1.1875,1.875,1.125,1.1875,1.0625,35.54006969,28.91986063,35.54006969,34,94.1,0.611111111,Portugal-Primeira-Liga,2022/05/06,2022/05/01 18:00
12,Portimonense,32,9,8,15,28,42,16,4,4,8,13,19,16,5,4,7,15,23,35,-14,2.19,1.3125,1.1875,1.4375,0.875,0.8125,0.9375,35.54006969,28.91986063,35.54006969,34,94.1,0.666666667,Portugal-Primeira-Liga,2022/05/06,2022/05/07 20:30
13,Famalicao,32,7,12,13,39,47,16,4,7,5,19,19,16,3,5,8,20,28,33,-8,2.69,1.46875,1.1875,1.75,1.21875,1.1875,1.25,35.54006969,28.91986063,35.54006969,34,94.1,0.722222222,Portugal-Primeira-Liga,2022/05/06,2022/05/09 20:15
14,Vizela,32,7,11,14,35,53,16,4,6,6,15,20,16,3,5,8,20,33,32,-18,2.75,1.65625,1.25,2.0625,1.09375,0.9375,1.25,35.54006969,28.91986063,35.54006969,34,94.1,0.777777778,Portugal-Primeira-Liga,2022/05/06,2022/05/08 15:30
14,Vizela,32,7,11,14,35,53,16,4,6,6,15,20,16,3,5,8,20,33,32,-18,2.75,1.65625,1.25,2.0625,1.09375,0.9375,1.25,35.54006969,28.91986063,35.54006969,34,94.1,0.777777778,Portugal-Primeira-Liga,2022/05/06,2022/04/30 19:00
15,Arouca,32,7,9,16,30,53,16,5,3,8,15,29,16,2,6,8,15,24,30,-23,2.59,1.65625,1.8125,1.5,0.9375,0.9375,0.9375,35.54006969,28.91986063,35.54006969,34,94.1,0.833333333,Portugal-Primeira-Liga,2022/05/06,2022/05/08 18:00
16,CD Tondela,32,7,6,19,39,62,16,4,3,9,22,31,16,3,3,10,17,31,27,-23,3.16,1.9375,1.9375,1.9375,1.21875,1.375,1.0625,35.54006969,28.91986063,35.54006969,34,94.1,0.888888889,Portugal-Primeira-Liga,2022/05/06,2022/05/02 20:15
16,CD Tondela,32,7,6,19,39,62,16,4,3,9,22,31,16,3,3,10,17,31,27,-23,3.16,1.9375,1.9375,1.9375,1.21875,1.375,1.0625,35.54006969,28.91986063,35.54006969,34,94.1,0.888888889,Portugal-Primeira-Liga,2022/05/06,2022/05/08 15:30
17,Moreirense,32,6,8,18,29,49,16,4,3,9,18,22,16,2,5,9,11,27,26,-20,2.44,1.53125,1.375,1.6875,0.90625,1.125,0.6875,35.54006969,28.91986063,35.54006969,34,94.1,0.944444444,Portugal-Primeira-Liga,2022/05/06,2022/05/01 18:00
17,Moreirense,32,6,8,18,29,49,16,4,3,9,18,22,16,2,5,9,11,27,26,-20,2.44,1.53125,1.375,1.6875,0.90625,1.125,0.6875,35.54006969,28.91986063,35.54006969,34,94.1,0.944444444,Portugal-Primeira-Liga,2022/05/06,2022/05/07 15:30
18,Belenenses,31,5,10,16,21,45,15,5,3,7,13,20,16,0,7,9,8,25,25,-24,2.13,1.451612903,1.333333333,1.5625,0.677419355,0.866666667,0.5,35.54006969,28.91986063,35.54006969,34,91.2,1,Portugal-Primeira-Liga,2022/05/06,2022/04/30 21:00
18,Belenenses,31,5,10,16,21,45,15,5,3,7,13,20,16,0,7,9,8,25,25,-24,2.13,1.451612903,1.333333333,1.5625,0.677419355,0.866666667,0.5,35.54006969,28.91986063,35.54006969,34,91.2,1,Portugal-Primeira-Liga,2022/05/06,2022/05/09 20:15
1,Zenit St Peter,27,18,7,2,64,26,14,12,1,1,42,15,13,6,6,1,22,11,61,38,3.33,0.962962963,1.071428571,0.846153846,2.37037037,3,1.692307692,37.73148148,24.53703704,37.73148148,30,90,0.0625,Russia-Premier,2022/05/06,2022/04/30 17:30
1,Zenit St Peter,27,18,7,2,64,26,14,12,1,1,42,15,13,6,6,1,22,11,61,38,3.33,0.962962963,1.071428571,0.846153846,2.37037037,3,1.692307692,37.73148148,24.53703704,37.73148148,30,90,0.0625,Russia-Premier,2022/05/06,2022/05/07 14:30
2,Din. Moscow,27,16,4,7,47,28,14,7,3,4,24,14,13,9,1,3,23,14,52,19,2.78,1.037037037,1,1.076923077,1.740740741,1.714285714,1.769230769,37.73148148,24.53703704,37.73148148,30,90,0.125,Russia-Premier,2022/05/06,2022/05/06 16:00
3,PFC Sochi,27,15,4,8,48,29,14,8,2,4,29,16,13,7,2,4,19,13,49,19,2.85,1.074074074,1.142857143,1,1.777777778,2.071428571,1.461538462,37.73148148,24.53703704,37.73148148,30,90,0.1875,Russia-Premier,2022/05/06,2022/05/07 17:00
4,CSKA Moscow,27,14,5,8,38,27,13,8,3,2,20,8,14,6,2,6,18,19,47,11,2.41,1,0.615384615,1.357142857,1.407407407,1.538461538,1.285714286,37.73148148,24.53703704,37.73148148,30,90,0.25,Russia-Premier,2022/05/06,2022/05/07 17:00
4,CSKA Moscow,27,14,5,8,38,27,13,8,3,2,20,8,14,6,2,6,18,19,47,11,2.41,1,0.615384615,1.357142857,1.407407407,1.538461538,1.285714286,37.73148148,24.53703704,37.73148148,30,90,0.25,Russia-Premier,2022/05/06,2022/05/01 17:00
5,FK Krasnodar,27,13,6,8,39,28,13,7,2,4,17,12,14,6,4,4,22,16,45,11,2.48,1.037037037,0.923076923,1.142857143,1.444444444,1.307692308,1.571428571,37.73148148,24.53703704,37.73148148,30,90,0.3125,Russia-Premier,2022/05/06,2022/04/30 14:30
5,FK Krasnodar,27,13,6,8,39,28,13,7,2,4,17,12,14,6,4,4,22,16,45,11,2.48,1.037037037,0.923076923,1.142857143,1.444444444,1.307692308,1.571428571,37.73148148,24.53703704,37.73148148,30,90,0.3125,Russia-Premier,2022/05/06,2022/05/04 17:00
5,FK Krasnodar,27,13,6,8,39,28,13,7,2,4,17,12,14,6,4,4,22,16,45,11,2.48,1.037037037,0.923076923,1.142857143,1.444444444,1.307692308,1.571428571,37.73148148,24.53703704,37.73148148,30,90,0.3125,Russia-Premier,2022/05/06,2022/05/08 14:30
6,Loko Moscow,27,11,8,8,38,36,13,8,1,4,21,14,14,3,7,4,17,22,41,2,2.74,1.333333333,1.076923077,1.571428571,1.407407407,1.615384615,1.214285714,37.73148148,24.53703704,37.73148148,30,90,0.375,Russia-Premier,2022/05/06,2022/05/08 17:00
6,Loko Moscow,27,11,8,8,38,36,13,8,1,4,21,14,14,3,7,4,17,22,41,2,2.74,1.333333333,1.076923077,1.571428571,1.407407407,1.615384615,1.214285714,37.73148148,24.53703704,37.73148148,30,90,0.375,Russia-Premier,2022/05/06,2022/04/30 17:30
6,Loko Moscow,27,11,8,8,38,36,13,8,1,4,21,14,14,3,7,4,17,22,41,2,2.74,1.333333333,1.076923077,1.571428571,1.407407407,1.615384615,1.214285714,37.73148148,24.53703704,37.73148148,30,90,0.375,Russia-Premier,2022/05/06,2022/05/04 17:00
7,Krylya Sov,27,11,5,11,34,32,13,6,3,4,20,12,14,5,2,7,14,20,38,2,2.44,1.185185185,0.923076923,1.428571429,1.259259259,1.538461538,1,37.73148148,24.53703704,37.73148148,30,90,0.4375,Russia-Premier,2022/05/06,2022/05/06 16:00
7,Krylya Sov,27,11,5,11,34,32,13,6,3,4,20,12,14,5,2,7,14,20,38,2,2.44,1.185185185,0.923076923,1.428571429,1.259259259,1.538461538,1,37.73148148,24.53703704,37.73148148,30,90,0.4375,Russia-Premier,2022/05/06,2022/05/01 12:00
8,Akhmat Grzny,27,11,2,14,33,37,14,8,0,6,22,17,13,3,2,8,11,20,35,-4,2.59,1.37037037,1.214285714,1.538461538,1.222222222,1.571428571,0.846153846,37.73148148,24.53703704,37.73148148,30,90,0.5,Russia-Premier,2022/05/06,2022/05/01 17:00
8,Akhmat Grzny,27,11,2,14,33,37,14,8,0,6,22,17,13,3,2,8,11,20,35,-4,2.59,1.37037037,1.214285714,1.538461538,1.222222222,1.571428571,0.846153846,37.73148148,24.53703704,37.73148148,30,90,0.5,Russia-Premier,2022/05/06,2022/05/07 14:30
9,FC Rostov,27,9,7,11,45,46,14,5,2,7,26,25,13,4,5,4,19,21,34,-1,3.37,1.703703704,1.785714286,1.615384615,1.666666667,1.857142857,1.461538462,37.73148148,24.53703704,37.73148148,30,90,0.5625,Russia-Premier,2022/05/06,2022/04/30 14:30
9,FC Rostov,27,9,7,11,45,46,14,5,2,7,26,25,13,4,5,4,19,21,34,-1,3.37,1.703703704,1.785714286,1.615384615,1.666666667,1.857142857,1.461538462,37.73148148,24.53703704,37.73148148,30,90,0.5625,Russia-Premier,2022/05/06,2022/05/08 12:00
10,Spartak Mos,27,9,7,11,32,37,14,6,4,4,21,16,13,3,3,7,11,21,34,-5,2.56,1.37037037,1.142857143,1.615384615,1.185185185,1.5,0.846153846,37.73148148,24.53703704,37.73148148,30,90,0.625,Russia-Premier,2022/05/06,2022/05/01 12:00
10,Spartak Mos,27,9,7,11,32,37,14,6,4,4,21,16,13,3,3,7,11,21,34,-5,2.56,1.37037037,1.142857143,1.615384615,1.185185185,1.5,0.846153846,37.73148148,24.53703704,37.73148148,30,90,0.625,Russia-Premier,2022/05/06,2022/05/07 12:00
11,Khimki,27,6,11,10,31,43,14,3,8,3,19,18,13,3,3,7,12,25,29,-12,2.74,1.592592593,1.285714286,1.923076923,1.148148148,1.357142857,0.923076923,37.73148148,24.53703704,37.73148148,30,90,0.6875,Russia-Premier,2022/05/06,2022/05/01 14:30
11,Khimki,27,6,11,10,31,43,14,3,8,3,19,18,13,3,3,7,12,25,29,-12,2.74,1.592592593,1.285714286,1.923076923,1.148148148,1.357142857,0.923076923,37.73148148,24.53703704,37.73148148,30,90,0.6875,Russia-Premier,2022/05/06,2022/05/07 14:30
12,Volga Olimp,27,7,8,12,25,38,13,3,3,7,11,18,14,4,5,5,14,20,29,-13,2.33,1.407407407,1.384615385,1.428571429,0.925925926,0.846153846,1,37.73148148,24.53703704,37.73148148,30,90,0.75,Russia-Premier,2022/05/06,2022/05/07 14:30
12,Volga Olimp,27,7,8,12,25,38,13,3,3,7,11,18,14,4,5,5,14,20,29,-13,2.33,1.407407407,1.384615385,1.428571429,0.925925926,0.846153846,1,37.73148148,24.53703704,37.73148148,30,90,0.75,Russia-Premier,2022/05/06,2022/05/02 17:00
13,Rubin Kazan,27,8,5,14,33,50,14,5,2,7,18,23,13,3,3,7,15,27,29,-17,3.07,1.851851852,1.642857143,2.076923077,1.222222222,1.285714286,1.153846154,37.73148148,24.53703704,37.73148148,30,90,0.8125,Russia-Premier,2022/05/06,2022/05/08 17:00
14,Ural Ekat,27,6,9,12,21,31,13,2,6,5,7,11,14,4,3,7,14,20,27,-10,1.93,1.148148148,0.846153846,1.428571429,0.777777778,0.538461538,1,37.73148148,24.53703704,37.73148148,30,90,0.875,Russia-Premier,2022/05/06,2022/05/07 12:00
15,FK UFA,27,4,11,12,25,38,13,2,7,4,14,16,14,2,4,8,11,22,23,-13,2.33,1.407407407,1.230769231,1.571428571,0.925925926,1.076923077,0.785714286,37.73148148,24.53703704,37.73148148,30,90,0.9375,Russia-Premier,2022/05/06,2022/05/08 12:00
15,FK UFA,27,4,11,12,25,38,13,2,7,4,14,16,14,2,4,8,11,22,23,-13,2.33,1.407407407,1.230769231,1.571428571,0.925925926,1.076923077,0.785714286,37.73148148,24.53703704,37.73148148,30,90,0.9375,Russia-Premier,2022/05/06,2022/05/01 14:30
16,Arsenal Tu,27,5,7,15,27,54,13,3,6,4,15,19,14,2,1,11,12,35,22,-27,3,2,1.461538462,2.5,1,1.153846154,0.857142857,37.73148148,24.53703704,37.73148148,30,90,1,Russia-Premier,2022/05/06,2022/05/02 17:00
16,Arsenal Tu,27,5,7,15,27,54,13,3,6,4,15,19,14,2,1,11,12,35,22,-27,3,2,1.461538462,2.5,1,1.153846154,0.857142857,37.73148148,24.53703704,37.73148148,30,90,1,Russia-Premier,2022/05/06,2022/05/08 14:30
1,Andorra,34,19,7,8,54,32,17,13,2,2,30,10,17,6,5,6,24,22,64,22,2.53,0.941176471,0.588235294,1.294117647,1.588235294,1.764705882,1.411764706,36.91176471,26.17647059,36.91176471,38,89.5,0.05,Spain-Primera-RFEF-Group-2,2022/05/06,2022/05/08 16:00
2,Albacete,34,18,10,6,48,27,17,14,2,1,32,6,17,4,8,5,16,21,64,21,2.21,0.794117647,0.352941176,1.235294118,1.411764706,1.882352941,0.941176471,36.91176471,26.17647059,36.91176471,38,89.5,0.1,Spain-Primera-RFEF-Group-2,2022/05/06,2022/05/01 11:00
2,Albacete,34,18,10,6,48,27,17,14,2,1,32,6,17,4,8,5,16,21,64,21,2.21,0.794117647,0.352941176,1.235294118,1.411764706,1.882352941,0.941176471,36.91176471,26.17647059,36.91176471,38,89.5,0.1,Spain-Primera-RFEF-Group-2,2022/05/06,2022/05/08 16:00
3,Villarreal 2,34,19,5,10,57,30,17,13,1,3,40,13,17,6,4,7,17,17,62,27,2.56,0.882352941,0.764705882,1,1.676470588,2.352941176,1,36.91176471,26.17647059,36.91176471,38,89.5,0.15,Spain-Primera-RFEF-Group-2,2022/05/06,2022/05/01 11:00
3,Villarreal 2,34,19,5,10,57,30,17,13,1,3,40,13,17,6,4,7,17,17,62,27,2.56,0.882352941,0.764705882,1,1.676470588,2.352941176,1,36.91176471,26.17647059,36.91176471,38,89.5,0.15,Spain-Primera-RFEF-Group-2,2022/05/06,2022/05/08 11:00
4,Sabadell,34,14,10,10,40,29,17,8,3,6,20,15,17,6,7,4,20,14,52,11,2.03,0.852941176,0.882352941,0.823529412,1.176470588,1.176470588,1.176470588,36.91176471,26.17647059,36.91176471,38,89.5,0.2,Spain-Primera-RFEF-Group-2,2022/05/06,2022/05/01 18:00
4,Sabadell,34,14,10,10,40,29,17,8,3,6,20,15,17,6,7,4,20,14,52,11,2.03,0.852941176,0.882352941,0.823529412,1.176470588,1.176470588,1.176470588,36.91176471,26.17647059,36.91176471,38,89.5,0.2,Spain-Primera-RFEF-Group-2,2022/05/06,2022/05/07 16:00
5,Atl Baleares,34,13,12,9,45,34,17,9,7,1,28,13,17,4,5,8,17,21,51,11,2.32,1,0.764705882,1.235294118,1.323529412,1.647058824,1,36.91176471,26.17647059,36.91176471,38,89.5,0.25,Spain-Primera-RFEF-Group-2,2022/05/06,2022/05/08 11:00
5,Atl Baleares,34,13,12,9,45,34,17,9,7,1,28,13,17,4,5,8,17,21,51,11,2.32,1,0.764705882,1.235294118,1.323529412,1.647058824,1,36.91176471,26.17647059,36.91176471,38,89.5,0.25,Spain-Primera-RFEF-Group-2,2022/05/06,2022/05/01 11:00
6,Linares,34,14,9,11,48,41,17,9,4,4,26,14,17,5,5,7,22,27,51,7,2.62,1.205882353,0.823529412,1.588235294,1.411764706,1.529411765,1.294117647,36.91176471,26.17647059,36.91176471,38,89.5,0.3,Spain-Primera-RFEF-Group-2,2022/05/06,2022/05/08 16:00
6,Linares,34,14,9,11,48,41,17,9,4,4,26,14,17,5,5,7,22,27,51,7,2.62,1.205882353,0.823529412,1.588235294,1.411764706,1.529411765,1.294117647,36.91176471,26.17647059,36.91176471,38,89.5,0.3,Spain-Primera-RFEF-Group-2,2022/05/06,2022/05/01 11:00
7,Alcoyano,34,13,12,9,37,32,17,6,7,4,17,14,17,7,5,5,20,18,51,5,2.03,0.941176471,0.823529412,1.058823529,1.088235294,1,1.176470588,36.91176471,26.17647059,36.91176471,38,89.5,0.35,Spain-Primera-RFEF-Group-2,2022/05/06,2022/05/01 11:00
7,Alcoyano,34,13,12,9,37,32,17,6,7,4,17,14,17,7,5,5,20,18,51,5,2.03,0.941176471,0.823529412,1.058823529,1.088235294,1,1.176470588,36.91176471,26.17647059,36.91176471,38,89.5,0.35,Spain-Primera-RFEF-Group-2,2022/05/06,2022/05/06 20:00
8,Barcelona 2,34,14,9,11,51,46,17,7,7,3,29,19,17,7,2,8,22,27,51,5,2.85,1.352941176,1.117647059,1.588235294,1.5,1.705882353,1.294117647,36.91176471,26.17647059,36.91176471,38,89.5,0.4,Spain-Primera-RFEF-Group-2,2022/05/06,2022/05/07 16:00
9,R Madrid B,34,14,7,13,55,41,17,11,3,3,40,15,17,3,4,10,15,26,49,14,2.82,1.205882353,0.882352941,1.529411765,1.617647059,2.352941176,0.882352941,36.91176471,26.17647059,36.91176471,38,89.5,0.45,Spain-Primera-RFEF-Group-2,2022/05/06,2022/05/08 11:00
10,Algeciras,34,13,10,11,43,38,17,7,8,2,24,15,17,6,2,9,19,23,49,5,2.38,1.117647059,0.882352941,1.352941176,1.264705882,1.411764706,1.117647059,36.91176471,26.17647059,36.91176471,38,89.5,0.5,Spain-Primera-RFEF-Group-2,2022/05/06,2022/05/07 18:00
11,Gimnastic,34,12,13,9,33,29,17,10,5,2,24,14,17,2,8,7,9,15,49,4,1.82,0.852941176,0.823529412,0.882352941,0.970588235,1.411764706,0.529411765,36.91176471,26.17647059,36.91176471,38,89.5,0.55,Spain-Primera-RFEF-Group-2,2022/05/06,2022/05/08 16:00
11,Gimnastic,34,12,13,9,33,29,17,10,5,2,24,14,17,2,8,7,9,15,49,4,1.82,0.852941176,0.823529412,0.882352941,0.970588235,1.411764706,0.529411765,36.91176471,26.17647059,36.91176471,38,89.5,0.55,Spain-Primera-RFEF-Group-2,2022/05/06,2022/05/01 18:00
12,CD Castellon,34,14,7,13,33,37,17,8,4,5,18,14,17,6,3,8,15,23,49,-4,2.06,1.088235294,0.823529412,1.352941176,0.970588235,1.058823529,0.882352941,36.91176471,26.17647059,36.91176471,38,89.5,0.6,Spain-Primera-RFEF-Group-2,2022/05/06,2022/05/08 11:00
13,CD San Fern,34,13,8,13,48,48,17,5,6,6,25,25,17,8,2,7,23,23,47,0,2.82,1.411764706,1.470588235,1.352941176,1.411764706,1.470588235,1.352941176,36.91176471,26.17647059,36.91176471,38,89.5,0.65,Spain-Primera-RFEF-Group-2,2022/05/06,2022/05/08 16:00
14,Rl B Linense,34,11,10,13,26,36,17,9,4,4,18,15,17,2,6,9,8,21,43,-10,1.82,1.058823529,0.882352941,1.235294118,0.764705882,1.058823529,0.470588235,36.91176471,26.17647059,36.91176471,38,89.5,0.7,Spain-Primera-RFEF-Group-2,2022/05/06,2022/05/08 16:00
15,Sevilla B,34,12,7,15,33,46,17,7,5,5,19,17,17,5,2,10,14,29,43,-13,2.32,1.352941176,1,1.705882353,0.970588235,1.117647059,0.823529412,36.91176471,26.17647059,36.91176471,38,89.5,0.75,Spain-Primera-RFEF-Group-2,2022/05/06,2022/05/07 18:00
16,Cornella,34,11,6,17,32,45,17,9,4,4,19,11,17,2,2,13,13,34,39,-13,2.26,1.323529412,0.647058824,2,0.941176471,1.117647059,0.764705882,36.91176471,26.17647059,36.91176471,38,89.5,0.8,Spain-Primera-RFEF-Group-2,2022/05/06,2022/05/07 18:00
17,Atl Sanluqu,34,10,9,15,36,54,17,5,6,6,17,19,17,5,3,9,19,35,39,-18,2.65,1.588235294,1.117647059,2.058823529,1.058823529,1,1.117647059,36.91176471,26.17647059,36.91176471,38,89.5,0.85,Spain-Primera-RFEF-Group-2,2022/05/06,2022/05/01 16:00
17,Atl Sanluqu,34,10,9,15,36,54,17,5,6,6,17,19,17,5,3,9,19,35,39,-18,2.65,1.588235294,1.117647059,2.058823529,1.058823529,1,1.117647059,36.91176471,26.17647059,36.91176471,38,89.5,0.85,Spain-Primera-RFEF-Group-2,2022/05/06,2022/05/07 18:00
18,UCAM Murcia,34,8,10,16,40,49,17,6,4,7,23,20,17,2,6,9,17,29,34,-9,2.62,1.441176471,1.176470588,1.705882353,1.176470588,1.352941176,1,36.91176471,26.17647059,36.91176471,38,89.5,0.9,Spain-Primera-RFEF-Group-2,2022/05/06,2022/05/01 11:00
18,UCAM Murcia,34,8,10,16,40,49,17,6,4,7,23,20,17,2,6,9,17,29,34,-9,2.62,1.441176471,1.176470588,1.705882353,1.176470588,1.352941176,1,36.91176471,26.17647059,36.91176471,38,89.5,0.9,Spain-Primera-RFEF-Group-2,2022/05/06,2022/05/07 16:00
19,Costa Brava,34,4,14,16,18,44,17,3,7,7,11,20,17,1,7,9,7,24,26,-26,1.82,1.294117647,1.176470588,1.411764706,0.529411765,0.647058824,0.411764706,36.91176471,26.17647059,36.91176471,38,89.5,0.95,Spain-Primera-RFEF-Group-2,2022/05/06,2022/05/07 16:00
19,Costa Brava,34,4,14,16,18,44,17,3,7,7,11,20,17,1,7,9,7,24,26,-26,1.82,1.294117647,1.176470588,1.411764706,0.529411765,0.647058824,0.411764706,36.91176471,26.17647059,36.91176471,38,89.5,0.95,Spain-Primera-RFEF-Group-2,2022/05/06,2022/05/01 16:00
20,Betis-B,34,5,3,26,20,59,17,3,0,14,13,35,17,2,3,12,7,24,18,-39,2.32,1.735294118,2.058823529,1.411764706,0.588235294,0.764705882,0.411764706,36.91176471,26.17647059,36.91176471,38,89.5,1,Spain-Primera-RFEF-Group-2,2022/05/06,2022/05/06 20:00
1,River Plate,25,16,6,3,53,19,13,9,2,2,31,9,12,7,4,1,22,10,54,34,2.88,0.76,0.692307692,0.833333333,2.12,2.384615385,1.833333333,35.23076923,29.53846154,35.23076923,50,50,0.038461538,Argentina-Copa-Liga-Profesional,2022/05/06,2022/05/09 01:00
2,Def-y-Just,25,13,8,4,43,24,12,8,3,1,24,11,13,5,5,3,19,13,47,19,2.68,0.96,0.916666667,1,1.72,2,1.461538462,35.23076923,29.53846154,35.23076923,50,50,0.076923077,Argentina-Copa-Liga-Profesional,2022/05/06,2022/05/08 20:00
3,Talleres,25,14,4,7,38,28,12,8,2,2,19,7,13,6,2,5,19,21,46,10,2.64,1.12,0.583333333,1.615384615,1.52,1.583333333,1.461538462,35.23076923,29.53846154,35.23076923,50,50,0.115384615,Argentina-Copa-Liga-Profesional,2022/05/06,2022/05/08 20:00
4,Boca Juniors,25,11,8,6,35,19,12,6,4,2,19,8,13,5,4,4,16,11,41,16,2.16,0.76,0.666666667,0.846153846,1.4,1.583333333,1.230769231,35.23076923,29.53846154,35.23076923,50,50,0.153846154,Argentina-Copa-Liga-Profesional,2022/05/06,2022/05/07 20:30
5,Velez,25,10,9,6,34,21,13,7,5,1,24,8,12,3,4,5,10,13,39,13,2.2,0.84,0.615384615,1.083333333,1.36,1.846153846,0.833333333,35.23076923,29.53846154,35.23076923,50,50,0.192307692,Argentina-Copa-Liga-Profesional,2022/05/06,2022/05/09 23:00
6,Estudiantes LP,25,10,9,6,43,31,12,5,5,2,20,11,13,5,4,4,23,20,39,12,2.96,1.24,0.916666667,1.538461538,1.72,1.666666667,1.769230769,35.23076923,29.53846154,35.23076923,50,50,0.230769231,Argentina-Copa-Liga-Profesional,2022/05/06,2022/05/07 23:00
7,Colon,25,11,6,8,26,31,12,7,3,2,16,11,13,4,3,6,10,20,39,-5,2.28,1.24,0.916666667,1.538461538,1.04,1.333333333,0.769230769,35.23076923,29.53846154,35.23076923,50,50,0.269230769,Argentina-Copa-Liga-Profesional,2022/05/06,2022/05/09 23:00
8,Independiente,25,10,8,7,27,24,13,6,5,2,15,8,12,4,3,5,12,16,38,3,2.04,0.96,0.615384615,1.333333333,1.08,1.153846154,1,35.23076923,29.53846154,35.23076923,50,50,0.307692308,Argentina-Copa-Liga-Profesional,2022/05/06,2022/05/07 20:30
9,Huracan,25,10,8,7,28,25,13,6,4,3,12,10,12,4,4,4,16,15,38,3,2.12,1,0.769230769,1.25,1.12,0.923076923,1.333333333,35.23076923,29.53846154,35.23076923,50,50,0.346153846,Argentina-Copa-Liga-Profesional,2022/05/06,2022/05/03 01:30
9,Huracan,25,10,8,7,28,25,13,6,4,3,12,10,12,4,4,4,16,15,38,3,2.12,1,0.769230769,1.25,1.12,0.923076923,1.333333333,35.23076923,29.53846154,35.23076923,50,50,0.346153846,Argentina-Copa-Liga-Profesional,2022/05/06,2022/05/07 20:30
10,Lanus,25,10,7,8,44,43,13,4,7,2,24,21,12,6,0,6,20,22,37,1,3.48,1.72,1.615384615,1.833333333,1.76,1.846153846,1.666666667,35.23076923,29.53846154,35.23076923,50,50,0.384615385,Argentina-Copa-Liga-Profesional,2022/05/06,2022/05/09 23:00
11,Gimnasia LP,25,9,9,7,27,28,13,5,6,2,18,13,12,4,3,5,9,15,36,-1,2.2,1.12,1,1.25,1.08,1.384615385,0.75,35.23076923,29.53846154,35.23076923,50,50,0.423076923,Argentina-Copa-Liga-Profesional,2022/05/06,2022/05/08 20:00
12,Union SF,25,10,4,11,32,32,13,6,2,5,22,13,12,4,2,6,10,19,34,0,2.56,1.28,1,1.583333333,1.28,1.692307692,0.833333333,35.23076923,29.53846154,35.23076923,50,50,0.461538462,Argentina-Copa-Liga-Profesional,2022/05/06,2022/05/08 20:00
13,Aldosivi,25,10,3,12,29,39,13,6,0,7,17,22,12,4,3,5,12,17,33,-10,2.72,1.56,1.692307692,1.416666667,1.16,1.307692308,1,35.23076923,29.53846154,35.23076923,50,50,0.5,Argentina-Copa-Liga-Profesional,2022/05/06,2022/05/07 20:30
14,Argentinos,25,8,8,9,26,25,12,6,3,3,16,8,13,2,5,6,10,17,32,1,2.04,1,0.666666667,1.307692308,1.04,1.333333333,0.769230769,35.23076923,29.53846154,35.23076923,50,50,0.538461538,Argentina-Copa-Liga-Profesional,2022/05/06,2022/05/08 20:00
15,Racing Club,25,8,8,9,24,23,12,4,4,4,12,10,13,4,4,5,12,13,32,1,1.88,0.92,0.833333333,1,0.96,1,0.923076923,35.23076923,29.53846154,35.23076923,50,50,0.576923077,Argentina-Copa-Liga-Profesional,2022/05/06,2022/05/06 22:30
16,Rosario Cent,25,9,5,11,39,41,12,6,1,5,20,17,13,3,4,6,19,24,32,-2,3.2,1.64,1.416666667,1.846153846,1.56,1.666666667,1.461538462,35.23076923,29.53846154,35.23076923,50,50,0.615384615,Argentina-Copa-Liga-Profesional,2022/05/06,2022/05/07 23:00
16,Rosario Cent,25,9,5,11,39,41,12,6,1,5,20,17,13,3,4,6,19,24,32,-2,3.2,1.64,1.416666667,1.846153846,1.56,1.666666667,1.461538462,35.23076923,29.53846154,35.23076923,50,50,0.615384615,Argentina-Copa-Liga-Profesional,2022/05/06,2022/05/03 01:30
17,Godoy Cruz,25,8,7,10,35,33,13,4,5,4,19,18,12,4,2,6,16,15,31,2,2.72,1.32,1.384615385,1.25,1.4,1.461538462,1.333333333,35.23076923,29.53846154,35.23076923,50,50,0.653846154,Argentina-Copa-Liga-Profesional,2022/05/06,2022/05/07 01:30
18,Platense,25,7,10,8,36,36,12,4,5,3,17,14,13,3,5,5,19,22,31,0,2.88,1.44,1.166666667,1.692307692,1.44,1.416666667,1.461538462,35.23076923,29.53846154,35.23076923,50,50,0.692307692,Argentina-Copa-Liga-Profesional,2022/05/06,2022/05/09 01:00
19,Newells,25,7,7,11,24,32,13,6,3,4,15,14,12,1,4,7,9,18,28,-8,2.24,1.28,1.076923077,1.5,0.96,1.153846154,0.75,35.23076923,29.53846154,35.23076923,50,50,0.730769231,Argentina-Copa-Liga-Profesional,2022/05/06,2022/05/08 20:00
20,Banfield,25,5,12,8,20,25,12,3,3,6,13,17,13,2,9,2,7,8,27,-5,1.8,1,1.416666667,0.615384615,0.8,1.083333333,0.538461538,35.23076923,29.53846154,35.23076923,50,50,0.769230769,Argentina-Copa-Liga-Profesional,2022/05/06,2022/05/10 01:30
21,San Lorenzo,25,7,6,12,23,33,12,6,2,4,15,12,13,1,4,8,8,21,27,-10,2.24,1.32,1,1.615384615,0.92,1.25,0.615384615,35.23076923,29.53846154,35.23076923,50,50,0.807692308,Argentina-Copa-Liga-Profesional,2022/05/06,2022/05/06 22:30
22,Cent Cordoba,25,6,8,11,30,36,13,5,3,5,21,17,12,1,5,6,9,19,26,-6,2.64,1.44,1.307692308,1.583333333,1.2,1.615384615,0.75,35.23076923,29.53846154,35.23076923,50,50,0.846153846,Argentina-Copa-Liga-Profesional,2022/05/06,2022/05/09 23:00
23,Patronato,25,5,10,10,23,35,12,4,5,3,14,13,13,1,5,7,9,22,25,-12,2.32,1.4,1.083333333,1.692307692,0.92,1.166666667,0.692307692,35.23076923,29.53846154,35.23076923,50,50,0.884615385,Argentina-Copa-Liga-Profesional,2022/05/06,2022/05/08 20:00
24,Sarmiento,25,6,6,13,23,33,13,5,2,6,16,16,12,1,4,7,7,17,24,-10,2.24,1.32,1.230769231,1.416666667,0.92,1.230769231,0.583333333,35.23076923,29.53846154,35.23076923,50,50,0.923076923,Argentina-Copa-Liga-Profesional,2022/05/06,2022/05/08 20:00
25,Atletico Tucum,25,5,7,13,22,46,12,3,6,3,13,16,13,2,1,10,9,30,22,-24,2.72,1.84,1.333333333,2.307692308,0.88,1.083333333,0.692307692,35.23076923,29.53846154,35.23076923,50,50,0.961538462,Argentina-Copa-Liga-Profesional,2022/05/06,2022/05/10 01:30
26,Arsenal Sar.,25,4,9,12,12,34,13,4,6,3,10,10,12,0,3,9,2,24,21,-22,1.84,1.36,0.769230769,2,0.48,0.769230769,0.166666667,35.23076923,29.53846154,35.23076923,50,50,1,Argentina-Copa-Liga-Profesional,2022/05/06,2022/05/07 20:30
1,Belouizdad,24,16,4,4,36,16,12,9,1,2,17,4,12,7,3,2,19,12,52,20,2.17,0.666666667,0.333333333,1,1.5,1.416666667,1.583333333,35.80246914,28.39506173,35.80246914,34,70.6,0.055555556,Algeria-Ligue-1,2022/05/06,2022/04/29 15:45
1,Belouizdad,24,16,4,4,36,16,12,9,1,2,17,4,12,7,3,2,19,12,52,20,2.17,0.666666667,0.333333333,1,1.5,1.416666667,1.583333333,35.80246914,28.39506173,35.80246914,34,70.6,0.055555556,Algeria-Ligue-1,2022/05/06,2022/05/06 17:45
2,MC Alger,28,13,9,6,35,18,14,10,3,1,25,7,14,3,6,5,10,11,48,17,1.89,0.642857143,0.5,0.785714286,1.25,1.785714286,0.714285714,35.80246914,28.39506173,35.80246914,34,82.4,0.111111111,Algeria-Ligue-1,2022/05/06,2022/04/29 22:30
2,MC Alger,28,13,9,6,35,18,14,10,3,1,25,7,14,3,6,5,10,11,48,17,1.89,0.642857143,0.5,0.785714286,1.25,1.785714286,0.714285714,35.80246914,28.39506173,35.80246914,34,82.4,0.111111111,Algeria-Ligue-1,2022/05/06,2022/05/07 18:00
3,JS Saoura,26,13,8,5,44,17,14,9,4,1,31,5,12,4,4,4,13,12,47,27,2.35,0.653846154,0.357142857,1,1.692307692,2.214285714,1.083333333,35.80246914,28.39506173,35.80246914,34,76.5,0.166666667,Algeria-Ligue-1,2022/05/06,2022/05/07 17:30
3,JS Saoura,26,13,8,5,44,17,14,9,4,1,31,5,12,4,4,4,13,12,47,27,2.35,0.653846154,0.357142857,1,1.692307692,2.214285714,1.083333333,35.80246914,28.39506173,35.80246914,34,76.5,0.166666667,Algeria-Ligue-1,2022/05/06,2022/04/29 22:30
4,Kabylie,27,12,11,4,32,16,13,7,4,2,17,7,14,5,7,2,15,9,47,16,1.78,0.592592593,0.538461538,0.642857143,1.185185185,1.307692308,1.071428571,35.80246914,28.39506173,35.80246914,34,79.4,0.222222222,Algeria-Ligue-1,2022/05/06,2022/05/06 17:45
4,Kabylie,27,12,11,4,32,16,13,7,4,2,17,7,14,5,7,2,15,9,47,16,1.78,0.592592593,0.538461538,0.642857143,1.185185185,1.307692308,1.071428571,35.80246914,28.39506173,35.80246914,34,79.4,0.222222222,Algeria-Ligue-1,2022/05/06,2022/04/29 22:30
5,Paradou,27,14,5,8,40,28,14,8,4,2,23,12,13,6,1,6,17,16,47,12,2.52,1.037037037,0.857142857,1.230769231,1.481481481,1.642857143,1.307692308,35.80246914,28.39506173,35.80246914,34,79.4,0.277777778,Algeria-Ligue-1,2022/05/06,2022/04/29 22:30
5,Paradou,27,14,5,8,40,28,14,8,4,2,23,12,13,6,1,6,17,16,47,12,2.52,1.037037037,0.857142857,1.230769231,1.481481481,1.642857143,1.307692308,35.80246914,28.39506173,35.80246914,34,79.4,0.277777778,Algeria-Ligue-1,2022/05/06,2022/05/06 16:00
6,CS Constantine,27,12,8,7,37,21,13,9,2,2,23,7,14,3,6,5,14,14,44,16,2.15,0.777777778,0.538461538,1,1.37037037,1.769230769,1,35.80246914,28.39506173,35.80246914,34,79.4,0.333333333,Algeria-Ligue-1,2022/05/06,2022/04/29 15:45
6,CS Constantine,27,12,8,7,37,21,13,9,2,2,23,7,14,3,6,5,14,14,44,16,2.15,0.777777778,0.538461538,1,1.37037037,1.769230769,1,35.80246914,28.39506173,35.80246914,34,79.4,0.333333333,Algeria-Ligue-1,2022/05/06,2022/05/07 17:30
7,Chlef,28,12,8,8,33,24,14,7,4,3,17,8,14,5,4,5,16,16,44,9,2.04,0.857142857,0.571428571,1.142857143,1.178571429,1.214285714,1.142857143,35.80246914,28.39506173,35.80246914,34,82.4,0.388888889,Algeria-Ligue-1,2022/05/06,2022/05/07 16:00
8,ES Setif,24,11,7,6,25,15,12,7,3,2,16,8,12,4,4,4,9,7,40,10,1.67,0.625,0.666666667,0.583333333,1.041666667,1.333333333,0.75,35.80246914,28.39506173,35.80246914,34,70.6,0.444444444,Algeria-Ligue-1,2022/05/06,2022/04/29 15:45
9,Biskra,27,11,7,9,31,27,14,9,3,2,17,8,13,2,4,7,14,19,40,4,2.15,1,0.571428571,1.461538462,1.148148148,1.214285714,1.076923077,35.80246914,28.39506173,35.80246914,34,79.4,0.5,Algeria-Ligue-1,2022/05/06,2022/05/07 18:00
10,USM Alger,27,9,12,6,32,19,13,7,6,0,21,6,14,2,6,6,11,13,39,13,1.89,0.703703704,0.461538462,0.928571429,1.185185185,1.615384615,0.785714286,35.80246914,28.39506173,35.80246914,34,79.4,0.555555556,Algeria-Ligue-1,2022/05/06,2022/05/06 18:00
10,USM Alger,27,9,12,6,32,19,13,7,6,0,21,6,14,2,6,6,11,13,39,13,1.89,0.703703704,0.461538462,0.928571429,1.185185185,1.615384615,0.785714286,35.80246914,28.39506173,35.80246914,34,79.4,0.555555556,Algeria-Ligue-1,2022/05/06,2022/04/29 15:45
11,MC Magra,28,11,4,13,25,31,14,8,3,3,14,8,14,3,1,10,11,23,37,-6,2,1.107142857,0.571428571,1.642857143,0.892857143,1,0.785714286,35.80246914,28.39506173,35.80246914,34,82.4,0.611111111,Algeria-Ligue-1,2022/05/06,2022/04/29 15:45
11,MC Magra,28,11,4,13,25,31,14,8,3,3,14,8,14,3,1,10,11,23,37,-6,2,1.107142857,0.571428571,1.642857143,0.892857143,1,0.785714286,35.80246914,28.39506173,35.80246914,34,82.4,0.611111111,Algeria-Ligue-1,2022/05/06,2022/05/07 16:00
12,MC Oran,27,7,12,8,22,27,14,5,7,2,16,14,13,2,5,6,6,13,33,-5,1.81,1,1,1,0.814814815,1.142857143,0.461538462,35.80246914,28.39506173,35.80246914,34,79.4,0.666666667,Algeria-Ligue-1,2022/05/06,2022/04/29 22:30
12,MC Oran,27,7,12,8,22,27,14,5,7,2,16,14,13,2,5,6,6,13,33,-5,1.81,1,1,1,0.814814815,1.142857143,0.461538462,35.80246914,28.39506173,35.80246914,34,79.4,0.666666667,Algeria-Ligue-1,2022/05/06,2022/05/07 16:00
13,RC Arba,27,7,11,9,25,33,14,5,6,3,15,14,13,2,5,6,10,19,32,-8,2.15,1.222222222,1,1.461538462,0.925925926,1.071428571,0.769230769,35.80246914,28.39506173,35.80246914,34,79.4,0.722222222,Algeria-Ligue-1,2022/05/06,2022/05/06 16:00
13,RC Arba,27,7,11,9,25,33,14,5,6,3,15,14,13,2,5,6,10,19,32,-8,2.15,1.222222222,1,1.461538462,0.925925926,1.071428571,0.769230769,35.80246914,28.39506173,35.80246914,34,79.4,0.722222222,Algeria-Ligue-1,2022/05/06,2022/04/29 15:45
14,Chelgh Laid,28,7,10,11,23,34,14,5,7,2,14,9,14,2,3,9,9,25,31,-11,2.04,1.214285714,0.642857143,1.785714286,0.821428571,1,0.642857143,35.80246914,28.39506173,35.80246914,34,82.4,0.777777778,Algeria-Ligue-1,2022/05/06,2022/05/07 16:00
14,Chelgh Laid,28,7,10,11,23,34,14,5,7,2,14,9,14,2,3,9,9,25,31,-11,2.04,1.214285714,0.642857143,1.785714286,0.821428571,1,0.642857143,35.80246914,28.39506173,35.80246914,34,82.4,0.777777778,Algeria-Ligue-1,2022/05/06,2022/04/29 15:45
15,Olympique Md,28,8,4,16,23,38,14,5,3,6,13,17,14,3,1,10,10,21,28,-15,2.18,1.357142857,1.214285714,1.5,0.821428571,0.928571429,0.714285714,35.80246914,28.39506173,35.80246914,34,82.4,0.833333333,Algeria-Ligue-1,2022/05/06,2022/04/29 15:45
15,Olympique Md,28,8,4,16,23,38,14,5,3,6,13,17,14,3,1,10,10,21,28,-15,2.18,1.357142857,1.214285714,1.5,0.821428571,0.928571429,0.714285714,35.80246914,28.39506173,35.80246914,34,82.4,0.833333333,Algeria-Ligue-1,2022/05/06,2022/05/07 16:00
16,Hussein Dey,28,5,7,16,28,47,13,3,3,7,16,26,15,2,4,9,12,21,22,-19,2.68,1.678571429,2,1.4,1,1.230769231,0.8,35.80246914,28.39506173,35.80246914,34,82.4,0.888888889,Algeria-Ligue-1,2022/05/06,2022/05/07 16:00
16,Hussein Dey,28,5,7,16,28,47,13,3,3,7,16,26,15,2,4,9,12,21,22,-19,2.68,1.678571429,2,1.4,1,1.230769231,0.8,35.80246914,28.39506173,35.80246914,34,82.4,0.888888889,Algeria-Ligue-1,2022/05/06,2022/04/29 22:30
17,Relizane,28,3,7,18,22,60,14,3,4,7,16,23,14,0,3,11,6,37,16,-38,2.93,2.142857143,1.642857143,2.642857143,0.785714286,1.142857143,0.428571429,35.80246914,28.39506173,35.80246914,34,82.4,0.944444444,Algeria-Ligue-1,2022/05/06,
18,Tlemcen,27,3,4,20,12,54,13,3,2,8,9,22,14,0,2,12,3,32,13,-42,2.44,2,1.692307692,2.285714286,0.444444444,0.692307692,0.214285714,35.80246914,28.39506173,35.80246914,34,79.4,1,Algeria-Ligue-1,2022/05/06,2022/05/06 18:00
1,Belgrano,12,10,1,1,18,8,6,6,0,0,12,4,6,4,1,1,6,4,31,10,2.17,0.666666667,0.666666667,0.666666667,1.5,2,1,29.74137931,40.51724138,29.74137931,72,16.7,0.027027027,Argentina-Primera,2022/05/06,2022/05/07 23:05
2,SM Tucuman,13,8,3,2,20,12,6,4,1,1,7,4,7,4,2,1,13,8,27,8,2.46,0.923076923,0.666666667,1.142857143,1.538461538,1.166666667,1.857142857,29.74137931,40.51724138,29.74137931,72,18.1,0.054054054,Argentina-Primera,2022/05/06,
3,Brown Adrogue,13,6,6,1,19,10,6,3,2,1,10,4,7,3,4,0,9,6,24,9,2.23,0.769230769,0.666666667,0.857142857,1.461538462,1.666666667,1.285714286,29.74137931,40.51724138,29.74137931,72,18.1,0.081081081,Argentina-Primera,2022/05/06,2022/05/08 15:00
4,Chacarita,13,6,4,3,24,18,6,2,3,1,12,7,7,4,1,2,12,11,22,6,3.23,1.384615385,1.166666667,1.571428571,1.846153846,2,1.714285714,29.74137931,40.51724138,29.74137931,72,18.1,0.108108108,Argentina-Primera,2022/05/06,2022/05/08 22:35
5,All Boys,12,5,6,1,17,11,6,2,4,0,9,6,6,3,2,1,8,5,21,6,2.33,0.916666667,1,0.833333333,1.416666667,1.5,1.333333333,29.74137931,40.51724138,29.74137931,72,16.7,0.135135135,Argentina-Primera,2022/05/06,
6,Estud Rio Cu,13,5,6,2,13,10,7,3,3,1,9,6,6,2,3,1,4,4,21,3,1.77,0.769230769,0.857142857,0.666666667,1,1.285714286,0.666666667,29.74137931,40.51724138,29.74137931,72,18.1,0.162162162,Argentina-Primera,2022/05/06,2022/05/08 20:00
7,Dep Madryn,13,5,5,3,19,14,7,3,2,2,11,8,6,2,3,1,8,6,20,5,2.54,1.076923077,1.142857143,1,1.461538462,1.571428571,1.333333333,29.74137931,40.51724138,29.74137931,72,18.1,0.189189189,Argentina-Primera,2022/05/06,2022/05/06 19:30
8,Dep Maipu,12,5,5,2,12,9,6,2,4,0,7,4,6,3,1,2,5,5,20,3,1.75,0.75,0.666666667,0.833333333,1,1.166666667,0.833333333,29.74137931,40.51724138,29.74137931,72,16.7,0.216216216,Argentina-Primera,2022/05/06,
9,Instituto,11,5,5,1,12,9,5,3,2,0,6,3,6,2,3,1,6,6,20,3,1.91,0.818181818,0.6,1,1.090909091,1.2,1,29.74137931,40.51724138,29.74137931,72,15.3,0.243243243,Argentina-Primera,2022/05/06,
10,Gim Mendoza,12,5,4,3,17,8,6,3,1,2,7,4,6,2,3,1,10,4,19,9,2.08,0.666666667,0.666666667,0.666666667,1.416666667,1.166666667,1.666666667,29.74137931,40.51724138,29.74137931,72,16.7,0.27027027,Argentina-Primera,2022/05/06,2022/05/08 20:00
11,Dep Riestra,12,4,7,1,10,6,6,3,3,0,6,2,6,1,4,1,4,4,19,4,1.33,0.5,0.333333333,0.666666667,0.833333333,1,0.666666667,29.74137931,40.51724138,29.74137931,72,16.7,0.297297297,Argentina-Primera,2022/05/06,2022/05/07 19:30
12,Chaco ForEver,13,3,9,1,14,11,6,3,3,0,7,3,7,0,6,1,7,8,18,3,1.92,0.846153846,0.5,1.142857143,1.076923077,1.166666667,1,29.74137931,40.51724138,29.74137931,72,18.1,0.324324324,Argentina-Primera,2022/05/06,2022/05/08 20:00
13,Estud Caser,13,4,6,3,12,10,6,2,4,0,5,2,7,2,2,3,7,8,18,2,1.69,0.769230769,0.333333333,1.142857143,0.923076923,0.833333333,1,29.74137931,40.51724138,29.74137931,72,18.1,0.351351351,Argentina-Primera,2022/05/06,2022/05/07 22:15
14,Almir Brown,13,4,6,3,16,15,7,4,3,0,11,6,6,0,3,3,5,9,18,1,2.38,1.153846154,0.857142857,1.5,1.230769231,1.571428571,0.833333333,29.74137931,40.51724138,29.74137931,72,18.1,0.378378378,Argentina-Primera,2022/05/06,2022/05/07 23:05
15,Almagro,13,5,3,5,12,15,7,3,1,3,8,8,6,2,2,2,4,7,18,-3,2.08,1.153846154,1.142857143,1.166666667,0.923076923,1.142857143,0.666666667,29.74137931,40.51724138,29.74137931,72,18.1,0.405405405,Argentina-Primera,2022/05/06,2022/05/07 01:10
16,Agropecuario,12,4,5,3,13,9,6,4,1,1,10,4,6,0,4,2,3,5,17,4,1.83,0.75,0.666666667,0.833333333,1.083333333,1.666666667,0.5,29.74137931,40.51724138,29.74137931,72,16.7,0.432432432,Argentina-Primera,2022/05/06,2022/05/07 23:00
17,S.Ma S.Juan,13,5,2,6,17,16,6,4,0,2,14,5,7,1,2,4,3,11,17,1,2.54,1.230769231,0.833333333,1.571428571,1.307692308,2.333333333,0.428571429,29.74137931,40.51724138,29.74137931,72,18.1,0.459459459,Argentina-Primera,2022/05/06,2022/05/07 20:00
18,Guillermo Br,13,5,2,6,11,12,6,2,1,3,4,4,7,3,1,3,7,8,17,-1,1.77,0.923076923,0.666666667,1.142857143,0.846153846,0.666666667,1,29.74137931,40.51724138,29.74137931,72,18.1,0.486486486,Argentina-Primera,2022/05/06,2022/05/08 19:00
19,Def Belgrano,13,4,5,4,14,16,6,2,2,2,7,8,7,2,3,2,7,8,17,-2,2.31,1.230769231,1.333333333,1.142857143,1.076923077,1.166666667,1,29.74137931,40.51724138,29.74137931,72,18.1,0.513513514,Argentina-Primera,2022/05/06,2022/05/07 19:30
20,Nueva Chic,13,3,7,3,16,14,7,2,4,1,8,4,6,1,3,2,8,10,16,2,2.31,1.076923077,0.571428571,1.666666667,1.230769231,1.142857143,1.333333333,29.74137931,40.51724138,29.74137931,72,18.1,0.540540541,Argentina-Primera,2022/05/06,2022/05/07 22:15
21,Quilmes,12,3,7,2,15,13,6,2,4,0,8,6,6,1,3,2,7,7,16,2,2.33,1.083333333,1,1.166666667,1.25,1.333333333,1.166666667,29.74137931,40.51724138,29.74137931,72,16.7,0.567567568,Argentina-Primera,2022/05/06,2022/05/07 23:00
22,Alvarado,13,4,4,5,16,21,7,4,2,1,12,5,6,0,2,4,4,16,16,-5,2.85,1.615384615,0.714285714,2.666666667,1.230769231,1.714285714,0.666666667,29.74137931,40.51724138,29.74137931,72,18.1,0.594594595,Argentina-Primera,2022/05/06,2022/05/07 20:00
23,Dep Moron,13,3,6,4,9,8,7,2,3,2,6,4,6,1,3,2,3,4,15,1,1.31,0.615384615,0.571428571,0.666666667,0.692307692,0.857142857,0.5,29.74137931,40.51724138,29.74137931,72,18.1,0.621621622,Argentina-Primera,2022/05/06,2022/05/08 20:00
24,CA Atlanta,13,3,6,4,14,15,6,2,4,0,9,5,7,1,2,4,5,10,15,-1,2.23,1.153846154,0.833333333,1.428571429,1.076923077,1.5,0.714285714,29.74137931,40.51724138,29.74137931,72,18.1,0.648648649,Argentina-Primera,2022/05/06,2022/05/07 01:10
25,Ind Rivadav,12,4,3,5,14,16,6,4,0,2,10,7,6,0,3,3,4,9,15,-2,2.5,1.333333333,1.166666667,1.5,1.166666667,1.666666667,0.666666667,29.74137931,40.51724138,29.74137931,72,16.7,0.675675676,Argentina-Primera,2022/05/06,2022/05/08 19:00
26,Atl.Rafaela,13,3,5,5,13,12,6,3,3,0,11,3,7,0,2,5,2,9,14,1,1.92,0.923076923,0.5,1.285714286,1,1.833333333,0.285714286,29.74137931,40.51724138,29.74137931,72,18.1,0.702702703,Argentina-Primera,2022/05/06,2022/05/07 23:00
27,San Telmo,12,2,6,4,12,20,6,1,4,1,5,7,6,1,2,3,7,13,12,-8,2.67,1.666666667,1.166666667,2.166666667,1,0.833333333,1.166666667,29.74137931,40.51724138,29.74137931,72,16.7,0.72972973,Argentina-Primera,2022/05/06,2022/05/06 19:30
28,MiSnt Estero,12,2,5,5,11,13,6,1,4,1,5,6,6,1,1,4,6,7,11,-2,2,1.083333333,1,1.166666667,0.916666667,0.833333333,1,29.74137931,40.51724138,29.74137931,72,16.7,0.756756757,Argentina-Primera,2022/05/06,2022/05/08 15:00
29,Atl Guemes,12,2,5,5,8,12,6,1,2,3,4,7,6,1,3,2,4,5,11,-4,1.67,1,1.166666667,0.833333333,0.666666667,0.666666667,0.666666667,29.74137931,40.51724138,29.74137931,72,16.7,0.783783784,Argentina-Primera,2022/05/06,2022/05/08 23:00
30,Gimnasia J,13,2,5,6,9,20,7,2,3,2,9,11,6,0,2,4,0,9,11,-11,2.23,1.538461538,1.571428571,1.5,0.692307692,1.285714286,0,29.74137931,40.51724138,29.74137931,72,18.1,0.810810811,Argentina-Primera,2022/05/06,2022/05/07 19:30
31,Sacachispas,12,1,7,4,10,13,6,1,3,2,5,6,6,0,4,2,5,7,10,-3,1.92,1.083333333,1,1.166666667,0.833333333,0.833333333,0.833333333,29.74137931,40.51724138,29.74137931,72,16.7,0.837837838,Argentina-Primera,2022/05/06,2022/05/07 19:30
32,Flandria,13,2,4,7,17,22,7,2,2,3,12,10,6,0,2,4,5,12,10,-5,3,1.692307692,1.428571429,2,1.307692308,1.714285714,0.833333333,29.74137931,40.51724138,29.74137931,72,18.1,0.864864865,Argentina-Primera,2022/05/06,2022/05/08 23:00
33,Temperley,13,2,4,7,11,18,7,1,2,4,5,8,6,1,2,3,6,10,10,-7,2.23,1.384615385,1.142857143,1.666666667,0.846153846,0.714285714,1,29.74137931,40.51724138,29.74137931,72,18.1,0.891891892,Argentina-Primera,2022/05/06,
34,Vil Dalmine,13,1,7,5,12,21,7,0,3,4,2,11,6,1,4,1,10,10,10,-9,2.54,1.615384615,1.571428571,1.666666667,0.923076923,0.285714286,1.666666667,29.74137931,40.51724138,29.74137931,72,18.1,0.918918919,Argentina-Primera,2022/05/06,
35,Tristan Suarz,11,1,6,4,14,17,6,1,4,1,11,11,5,0,2,3,3,6,9,-3,2.82,1.545454545,1.833333333,1.2,1.272727273,1.833333333,0.6,29.74137931,40.51724138,29.74137931,72,15.3,0.945945946,Argentina-Primera,2022/05/06,2022/05/07 23:00
36,Ferro,12,1,6,5,11,17,6,0,3,3,4,9,6,1,3,2,7,8,9,-6,2.33,1.416666667,1.5,1.333333333,0.916666667,0.666666667,1.166666667,29.74137931,40.51724138,29.74137931,72,16.7,0.972972973,Argentina-Primera,2022/05/06,2022/05/08 22:35
37,Santa Tandil,13,1,5,7,10,21,6,0,4,2,5,7,7,1,1,5,5,14,8,-11,2.38,1.615384615,1.166666667,2,0.769230769,0.833333333,0.714285714,29.74137931,40.51724138,29.74137931,72,18.1,1,Argentina-Primera,2022/05/06,
1,Midland,11,6,4,1,23,11,6,3,3,0,10,2,5,3,1,1,13,9,22,12,3.09,1,0.333333333,1.8,2.090909091,1.666666667,2.6,33.33333333,33.33333333,33.33333333,36,30.6,0.052631579,Argentina-Primera-C-Metropolitana-,2022/05/06,2022/05/06 19:30
2,Lean Nicefo,12,6,4,2,12,7,6,3,2,1,8,5,6,3,2,1,4,2,22,5,1.58,0.583333333,0.833333333,0.333333333,1,1.333333333,0.666666667,33.33333333,33.33333333,33.33333333,36,33.3,0.105263158,Argentina-Primera-C-Metropolitana-,2022/05/06,
3,Berazategui,11,6,3,2,13,8,5,3,1,1,5,3,6,3,2,1,8,5,21,5,1.91,0.727272727,0.6,0.833333333,1.181818182,1,1.333333333,33.33333333,33.33333333,33.33333333,36,30.6,0.157894737,Argentina-Primera-C-Metropolitana-,2022/05/06,2022/05/06 19:30
4,Dep Espanol,12,5,5,2,17,9,6,3,2,1,9,4,6,2,3,1,8,5,20,8,2.17,0.75,0.666666667,0.833333333,1.416666667,1.5,1.333333333,33.33333333,33.33333333,33.33333333,36,33.3,0.210526316,Argentina-Primera-C-Metropolitana-,2022/05/06,2022/05/10 19:30
4,Dep Espanol,12,5,5,2,17,9,6,3,2,1,9,4,6,2,3,1,8,5,20,8,2.17,0.75,0.666666667,0.833333333,1.416666667,1.5,1.333333333,33.33333333,33.33333333,33.33333333,36,33.3,0.210526316,Argentina-Primera-C-Metropolitana-,2022/05/06,2022/05/06 23:00
5,Sp Italiano,12,5,5,2,15,7,6,3,2,1,9,3,6,2,3,1,6,4,20,8,1.83,0.583333333,0.5,0.666666667,1.25,1.5,1,33.33333333,33.33333333,33.33333333,36,33.3,0.263157895,Argentina-Primera-C-Metropolitana-,2022/05/06,2022/05/06 19:30
6,Real Pilar,11,6,2,3,10,5,5,2,2,1,6,3,6,4,0,2,4,2,20,5,1.36,0.454545455,0.6,0.333333333,0.909090909,1.2,0.666666667,33.33333333,33.33333333,33.33333333,36,30.6,0.315789474,Argentina-Primera-C-Metropolitana-,2022/05/06,2022/05/06 23:00
7,Laferrere,12,4,8,0,7,2,6,2,4,0,5,2,6,2,4,0,2,0,20,5,0.75,0.166666667,0.333333333,0,0.583333333,0.833333333,0.333333333,33.33333333,33.33333333,33.33333333,36,33.3,0.368421053,Argentina-Primera-C-Metropolitana-,2022/05/06,2022/05/06 23:15
7,Laferrere,12,4,8,0,7,2,6,2,4,0,5,2,6,2,4,0,2,0,20,5,0.75,0.166666667,0.333333333,0,0.583333333,0.833333333,0.333333333,33.33333333,33.33333333,33.33333333,36,33.3,0.368421053,Argentina-Primera-C-Metropolitana-,2022/05/06,2022/05/10 19:30
8,Excursionist,11,5,5,1,12,9,6,3,3,0,9,4,5,2,2,1,3,5,20,3,1.91,0.818181818,0.666666667,1,1.090909091,1.5,0.6,33.33333333,33.33333333,33.33333333,36,30.6,0.421052632,Argentina-Primera-C-Metropolitana-,2022/05/06,2022/05/06 19:30
9,Claypole,11,4,4,3,10,10,6,4,1,1,8,4,5,0,3,2,2,6,16,0,1.82,0.909090909,0.666666667,1.2,0.909090909,1.333333333,0.4,33.33333333,33.33333333,33.33333333,36,30.6,0.473684211,Argentina-Primera-C-Metropolitana-,2022/05/06,2022/05/10 19:30
9,Claypole,11,4,4,3,10,10,6,4,1,1,8,4,5,0,3,2,2,6,16,0,1.82,0.909090909,0.666666667,1.2,0.909090909,1.333333333,0.4,33.33333333,33.33333333,33.33333333,36,30.6,0.473684211,Argentina-Primera-C-Metropolitana-,2022/05/06,2022/05/06 23:15
10,Atl Atlas,11,4,3,4,11,10,6,3,2,1,9,6,5,1,1,3,2,4,15,1,1.91,0.909090909,1,0.8,1,1.5,0.4,33.33333333,33.33333333,33.33333333,36,30.6,0.526315789,Argentina-Primera-C-Metropolitana-,2022/05/06,2022/05/10 19:30
10,Atl Atlas,11,4,3,4,11,10,6,3,2,1,9,6,5,1,1,3,2,4,15,1,1.91,0.909090909,1,0.8,1,1.5,0.4,33.33333333,33.33333333,33.33333333,36,30.6,0.526315789,Argentina-Primera-C-Metropolitana-,2022/05/06,2022/05/06 19:30
11,Argent Merlo,11,4,3,4,11,13,5,2,1,2,5,7,6,2,2,2,6,6,15,-2,2.18,1.181818182,1.4,1,1,1,1,33.33333333,33.33333333,33.33333333,36,30.6,0.578947368,Argentina-Primera-C-Metropolitana-,2022/05/06,2022/05/06 19:30
11,Argent Merlo,11,4,3,4,11,13,5,2,1,2,5,7,6,2,2,2,6,6,15,-2,2.18,1.181818182,1.4,1,1,1,1,33.33333333,33.33333333,33.33333333,36,30.6,0.578947368,Argentina-Primera-C-Metropolitana-,2022/05/06,2022/05/10 19:30
12,Gen Lamadrid,11,4,2,5,12,14,5,2,1,2,5,6,6,2,1,3,7,8,14,-2,2.36,1.272727273,1.2,1.333333333,1.090909091,1,1.166666667,33.33333333,33.33333333,33.33333333,36,30.6,0.631578947,Argentina-Primera-C-Metropolitana-,2022/05/06,2022/05/06 19:30
12,Gen Lamadrid,11,4,2,5,12,14,5,2,1,2,5,6,6,2,1,3,7,8,14,-2,2.36,1.272727273,1.2,1.333333333,1.090909091,1,1.166666667,33.33333333,33.33333333,33.33333333,36,30.6,0.631578947,Argentina-Primera-C-Metropolitana-,2022/05/06,2022/05/10 19:30
13,Cent Cordoba,12,3,4,5,14,14,6,2,3,1,10,5,6,1,1,4,4,9,13,0,2.33,1.166666667,0.833333333,1.5,1.166666667,1.666666667,0.666666667,33.33333333,33.33333333,33.33333333,36,33.3,0.684210526,Argentina-Primera-C-Metropolitana-,2022/05/06,2022/05/10 19:30
13,Cent Cordoba,12,3,4,5,14,14,6,2,3,1,10,5,6,1,1,4,4,9,13,0,2.33,1.166666667,0.833333333,1.5,1.166666667,1.666666667,0.666666667,33.33333333,33.33333333,33.33333333,36,33.3,0.684210526,Argentina-Primera-C-Metropolitana-,2022/05/06,2022/05/06 19:30
14,Liniers,11,4,1,6,14,16,6,3,0,3,8,8,5,1,1,3,6,8,13,-2,2.73,1.454545455,1.333333333,1.6,1.272727273,1.333333333,1.2,33.33333333,33.33333333,33.33333333,36,30.6,0.736842105,Argentina-Primera-C-Metropolitana-,2022/05/06,2022/05/10 19:30
14,Liniers,11,4,1,6,14,16,6,3,0,3,8,8,5,1,1,3,6,8,13,-2,2.73,1.454545455,1.333333333,1.6,1.272727273,1.333333333,1.2,33.33333333,33.33333333,33.33333333,36,30.6,0.736842105,Argentina-Primera-C-Metropolitana-,2022/05/06,2022/05/06 19:30
15,Lujan,12,2,6,4,10,14,6,2,2,2,5,5,6,0,4,2,5,9,12,-4,2,1.166666667,0.833333333,1.5,0.833333333,0.833333333,0.833333333,33.33333333,33.33333333,33.33333333,36,33.3,0.789473684,Argentina-Primera-C-Metropolitana-,2022/05/06,2022/05/06 19:30
16,Sn Mart Burz,11,1,5,5,7,14,5,1,3,1,3,3,6,0,2,4,4,11,8,-7,1.91,1.272727273,0.6,1.833333333,0.636363636,0.6,0.666666667,33.33333333,33.33333333,33.33333333,36,30.6,0.842105263,Argentina-Primera-C-Metropolitana-,2022/05/06,2022/05/06 19:30
16,Sn Mart Burz,11,1,5,5,7,14,5,1,3,1,3,3,6,0,2,4,4,11,8,-7,1.91,1.272727273,0.6,1.833333333,0.636363636,0.6,0.666666667,33.33333333,33.33333333,33.33333333,36,30.6,0.842105263,Argentina-Primera-C-Metropolitana-,2022/05/06,2022/05/10 19:30
17,Victoriano,11,2,2,7,9,17,6,2,1,3,5,5,5,0,1,4,4,12,8,-8,2.36,1.545454545,0.833333333,2.4,0.818181818,0.833333333,0.8,33.33333333,33.33333333,33.33333333,36,30.6,0.894736842,Argentina-Primera-C-Metropolitana-,2022/05/06,2022/05/10 19:30
17,Victoriano,11,2,2,7,9,17,6,2,1,3,5,5,5,0,1,4,4,12,8,-8,2.36,1.545454545,0.833333333,2.4,0.818181818,0.833333333,0.8,33.33333333,33.33333333,33.33333333,36,30.6,0.894736842,Argentina-Primera-C-Metropolitana-,2022/05/06,2022/05/06 19:30
18,Puerto Nuevo,12,1,3,8,7,22,6,1,0,5,4,12,6,0,3,3,3,10,6,-15,2.42,1.833333333,2,1.666666667,0.583333333,0.666666667,0.5,33.33333333,33.33333333,33.33333333,36,33.3,0.947368421,Argentina-Primera-C-Metropolitana-,2022/05/06,2022/05/06 19:30
18,Puerto Nuevo,12,1,3,8,7,22,6,1,0,5,4,12,6,0,3,3,3,10,6,-15,2.42,1.833333333,2,1.666666667,0.583333333,0.666666667,0.5,33.33333333,33.33333333,33.33333333,36,33.3,0.947368421,Argentina-Primera-C-Metropolitana-,2022/05/06,2022/05/10 19:30
19,El Porvenir,11,0,3,8,7,19,5,0,3,2,4,7,6,0,0,6,3,12,3,-12,2.36,1.727272727,1.4,2,0.636363636,0.8,0.5,33.33333333,33.33333333,33.33333333,36,30.6,1,Argentina-Primera-C-Metropolitana-,2022/05/06,2022/05/06 19:30
19,El Porvenir,11,0,3,8,7,19,5,0,3,2,4,7,6,0,0,6,3,12,3,-12,2.36,1.727272727,1.4,2,0.636363636,0.8,0.5,33.33333333,33.33333333,33.33333333,36,30.6,1,Argentina-Primera-C-Metropolitana-,2022/05/06,2022/05/10 19:30
1,Sydney U21,9,6,2,1,27,18,5,4,1,0,13,8,4,2,1,1,14,10,20,9,5,2,1.6,2.5,3,2.6,3.5,40.74074074,18.51851852,40.74074074,22,40.9,0.083333333,Australia-New-South-Wales,2022/05/06,2022/05/08 09:30
1,Sydney U21,9,6,2,1,27,18,5,4,1,0,13,8,4,2,1,1,14,10,20,9,5,2,1.6,2.5,3,2.6,3.5,40.74074074,18.51851852,40.74074074,22,40.9,0.083333333,Australia-New-South-Wales,2022/05/06,2022/05/01 06:00
2,APIA LT,9,6,1,2,23,12,4,4,0,0,7,0,5,2,1,2,16,12,19,11,3.89,1.333333333,0,2.4,2.555555556,1.75,3.2,40.74074074,18.51851852,40.74074074,22,40.9,0.166666667,Australia-New-South-Wales,2022/05/06,2022/05/01 08:15
2,APIA LT,9,6,1,2,23,12,4,4,0,0,7,0,5,2,1,2,16,12,19,11,3.89,1.333333333,0,2.4,2.555555556,1.75,3.2,40.74074074,18.51851852,40.74074074,22,40.9,0.166666667,Australia-New-South-Wales,2022/05/06,2022/05/07 09:00
3,Blacktown CD,9,6,1,2,19,11,7,5,1,1,16,9,2,1,0,1,3,2,19,8,3.33,1.222222222,1.285714286,1,2.111111111,2.285714286,1.5,40.74074074,18.51851852,40.74074074,22,40.9,0.25,Australia-New-South-Wales,2022/05/06,2022/04/24 08:00
3,Blacktown CD,9,6,1,2,19,11,7,5,1,1,16,9,2,1,0,1,3,2,19,8,3.33,1.222222222,1.285714286,1,2.111111111,2.285714286,1.5,40.74074074,18.51851852,40.74074074,22,40.9,0.25,Australia-New-South-Wales,2022/05/06,2022/05/01 06:00
3,Blacktown CD,9,6,1,2,19,11,7,5,1,1,16,9,2,1,0,1,3,2,19,8,3.33,1.222222222,1.285714286,1,2.111111111,2.285714286,1.5,40.74074074,18.51851852,40.74074074,22,40.9,0.25,Australia-New-South-Wales,2022/05/06,2022/05/06 10:30
4,Rockdale Ili,9,5,3,1,18,10,4,3,1,0,10,6,5,2,2,1,8,4,18,8,3.11,1.111111111,1.5,0.8,2,2.5,1.6,40.74074074,18.51851852,40.74074074,22,40.9,0.333333333,Australia-New-South-Wales,2022/05/06,2022/05/01 07:00
4,Rockdale Ili,9,5,3,1,18,10,4,3,1,0,10,6,5,2,2,1,8,4,18,8,3.11,1.111111111,1.5,0.8,2,2.5,1.6,40.74074074,18.51851852,40.74074074,22,40.9,0.333333333,Australia-New-South-Wales,2022/05/06,2022/05/08 09:30
5,Marconi Stall,9,4,3,2,19,14,6,3,2,1,13,9,3,1,1,1,6,5,15,5,3.67,1.555555556,1.5,1.666666667,2.111111111,2.166666667,2,40.74074074,18.51851852,40.74074074,22,40.9,0.416666667,Australia-New-South-Wales,2022/05/06,2022/04/30 10:00
5,Marconi Stall,9,4,3,2,19,14,6,3,2,1,13,9,3,1,1,1,6,5,15,5,3.67,1.555555556,1.5,1.666666667,2.111111111,2.166666667,2,40.74074074,18.51851852,40.74074074,22,40.9,0.416666667,Australia-New-South-Wales,2022/05/06,2022/05/07 09:00
5,Marconi Stall,9,4,3,2,19,14,6,3,2,1,13,9,3,1,1,1,6,5,15,5,3.67,1.555555556,1.5,1.666666667,2.111111111,2.166666667,2,40.74074074,18.51851852,40.74074074,22,40.9,0.416666667,Australia-New-South-Wales,2022/05/06,2022/04/26 10:30
6,Manly United,9,4,2,3,14,11,2,2,0,0,5,0,7,2,2,3,9,11,14,3,2.78,1.222222222,0,1.571428571,1.555555556,2.5,1.285714286,40.74074074,18.51851852,40.74074074,22,40.9,0.5,Australia-New-South-Wales,2022/05/06,2022/05/06 10:00
6,Manly United,9,4,2,3,14,11,2,2,0,0,5,0,7,2,2,3,9,11,14,3,2.78,1.222222222,0,1.571428571,1.555555556,2.5,1.285714286,40.74074074,18.51851852,40.74074074,22,40.9,0.5,Australia-New-South-Wales,2022/05/06,2022/04/24 08:00
6,Manly United,9,4,2,3,14,11,2,2,0,0,5,0,7,2,2,3,9,11,14,3,2.78,1.222222222,0,1.571428571,1.555555556,2.5,1.285714286,40.74074074,18.51851852,40.74074074,22,40.9,0.5,Australia-New-South-Wales,2022/05/06,2022/04/30 10:00
7,Sydney Olymp,9,4,2,3,14,13,4,1,1,2,3,6,5,3,1,1,11,7,14,1,3,1.444444444,1.5,1.4,1.555555556,0.75,2.2,40.74074074,18.51851852,40.74074074,22,40.9,0.583333333,Australia-New-South-Wales,2022/05/06,2022/05/01 08:15
7,Sydney Olymp,9,4,2,3,14,13,4,1,1,2,3,6,5,3,1,1,11,7,14,1,3,1.444444444,1.5,1.4,1.555555556,0.75,2.2,40.74074074,18.51851852,40.74074074,22,40.9,0.583333333,Australia-New-South-Wales,2022/05/06,2022/05/07 08:00
7,Sydney Olymp,9,4,2,3,14,13,4,1,1,2,3,6,5,3,1,1,11,7,14,1,3,1.444444444,1.5,1.4,1.555555556,0.75,2.2,40.74074074,18.51851852,40.74074074,22,40.9,0.583333333,Australia-New-South-Wales,2022/05/06,2022/04/27 10:30
8,Sydney Utd,9,3,1,5,13,24,5,1,1,3,4,13,4,2,0,2,9,11,10,-11,4.11,2.666666667,2.6,2.75,1.444444444,0.8,2.25,40.74074074,18.51851852,40.74074074,22,40.9,0.666666667,Australia-New-South-Wales,2022/05/06,2022/05/01 06:00
8,Sydney Utd,9,3,1,5,13,24,5,1,1,3,4,13,4,2,0,2,9,11,10,-11,4.11,2.666666667,2.6,2.75,1.444444444,0.8,2.25,40.74074074,18.51851852,40.74074074,22,40.9,0.666666667,Australia-New-South-Wales,2022/05/06,2022/05/06 10:00
9,Wollongongs,9,2,2,5,13,14,3,1,2,0,8,5,6,1,0,5,5,9,8,-1,3,1.555555556,1.666666667,1.5,1.444444444,2.666666667,0.833333333,40.74074074,18.51851852,40.74074074,22,40.9,0.75,Australia-New-South-Wales,2022/05/06,2022/04/27 10:30
9,Wollongongs,9,2,2,5,13,14,3,1,2,0,8,5,6,1,0,5,5,9,8,-1,3,1.555555556,1.666666667,1.5,1.444444444,2.666666667,0.833333333,40.74074074,18.51851852,40.74074074,22,40.9,0.75,Australia-New-South-Wales,2022/05/06,2022/05/06 10:30
9,Wollongongs,9,2,2,5,13,14,3,1,2,0,8,5,6,1,0,5,5,9,8,-1,3,1.555555556,1.666666667,1.5,1.444444444,2.666666667,0.833333333,40.74074074,18.51851852,40.74074074,22,40.9,0.75,Australia-New-South-Wales,2022/05/06,2022/04/30 10:00
10,Sutherland,9,2,0,7,12,21,5,1,0,4,7,12,4,1,0,3,5,9,6,-9,3.67,2.333333333,2.4,2.25,1.333333333,1.4,1.25,40.74074074,18.51851852,40.74074074,22,40.9,0.833333333,Australia-New-South-Wales,2022/05/06,2022/05/01 06:00
10,Sutherland,9,2,0,7,12,21,5,1,0,4,7,12,4,1,0,3,5,9,6,-9,3.67,2.333333333,2.4,2.25,1.333333333,1.4,1.25,40.74074074,18.51851852,40.74074074,22,40.9,0.833333333,Australia-New-South-Wales,2022/05/06,2022/05/07 06:00
11,Druitt Tn Rg,9,1,2,6,19,29,5,1,0,4,13,18,4,0,2,2,6,11,5,-10,5.33,3.222222222,3.6,2.75,2.111111111,2.6,1.5,40.74074074,18.51851852,40.74074074,22,40.9,0.916666667,Australia-New-South-Wales,2022/05/06,2022/04/26 10:30
11,Druitt Tn Rg,9,1,2,6,19,29,5,1,0,4,13,18,4,0,2,2,6,11,5,-10,5.33,3.222222222,3.6,2.75,2.111111111,2.6,1.5,40.74074074,18.51851852,40.74074074,22,40.9,0.916666667,Australia-New-South-Wales,2022/05/06,2022/04/30 10:00
11,Druitt Tn Rg,9,1,2,6,19,29,5,1,0,4,13,18,4,0,2,2,6,11,5,-10,5.33,3.222222222,3.6,2.75,2.111111111,2.6,1.5,40.74074074,18.51851852,40.74074074,22,40.9,0.916666667,Australia-New-South-Wales,2022/05/06,2022/05/07 08:00
12,Northbridge,9,1,1,7,14,28,4,1,1,2,8,12,5,0,0,5,6,16,4,-14,4.67,3.111111111,3,3.2,1.555555556,2,1.2,40.74074074,18.51851852,40.74074074,22,40.9,1,Australia-New-South-Wales,2022/05/06,2022/05/07 06:00
12,Northbridge,9,1,1,7,14,28,4,1,1,2,8,12,5,0,0,5,6,16,4,-14,4.67,3.111111111,3,3.2,1.555555556,2,1.2,40.74074074,18.51851852,40.74074074,22,40.9,1,Australia-New-South-Wales,2022/05/06,2022/05/01 07:00
1,S Melbourne,11,9,1,1,30,7,5,5,0,0,18,1,6,4,1,1,12,6,28,23,3.36,0.636363636,0.2,1,2.727272727,3.6,2,42.76315789,14.47368421,42.76315789,24,45.8,0.076923077,Australia-Victoria,2022/05/06,2022/04/30 09:45
1,S Melbourne,11,9,1,1,30,7,5,5,0,0,18,1,6,4,1,1,12,6,28,23,3.36,0.636363636,0.2,1,2.727272727,3.6,2,42.76315789,14.47368421,42.76315789,24,45.8,0.076923077,Australia-Victoria,2022/05/06,2022/04/25 09:00
1,S Melbourne,11,9,1,1,30,7,5,5,0,0,18,1,6,4,1,1,12,6,28,23,3.36,0.636363636,0.2,1,2.727272727,3.6,2,42.76315789,14.47368421,42.76315789,24,45.8,0.076923077,Australia-Victoria,2022/05/06,2022/05/07 07:45
2,Dandenong Th,22,6,6,10,25,40,12,4,4,4,15,27,10,2,2,6,10,13,24,-15,2.95,1.818181818,2.25,1.3,1.136363636,1.25,1,42.76315789,14.47368421,42.76315789,24,91.7,0.153846154,Australia-Victoria,2022/05/06,2022/05/07 07:45
2,Dandenong Th,22,6,6,10,25,40,12,4,4,4,15,27,10,2,2,6,10,13,24,-15,2.95,1.818181818,2.25,1.3,1.136363636,1.25,1,42.76315789,14.47368421,42.76315789,24,91.7,0.153846154,Australia-Victoria,2022/05/06,2022/05/07 10:00
2,Dandenong Th,22,6,6,10,25,40,12,4,4,4,15,27,10,2,2,6,10,13,24,-15,2.95,1.818181818,2.25,1.3,1.136363636,1.25,1,42.76315789,14.47368421,42.76315789,24,91.7,0.153846154,Australia-Victoria,2022/05/06,2022/04/30 06:15
2,Dandenong Th,22,6,6,10,25,40,12,4,4,4,15,27,10,2,2,6,10,13,24,-15,2.95,1.818181818,2.25,1.3,1.136363636,1.25,1,42.76315789,14.47368421,42.76315789,24,91.7,0.153846154,Australia-Victoria,2022/05/06,2022/05/01 06:00
3,Oakleigh Cn,10,7,1,2,24,12,6,4,1,1,14,8,4,3,0,1,10,4,22,12,3.6,1.2,1.333333333,1,2.4,2.333333333,2.5,42.76315789,14.47368421,42.76315789,24,41.7,0.230769231,Australia-Victoria,2022/05/06,2022/04/25 08:30
3,Oakleigh Cn,10,7,1,2,24,12,6,4,1,1,14,8,4,3,0,1,10,4,22,12,3.6,1.2,1.333333333,1,2.4,2.333333333,2.5,42.76315789,14.47368421,42.76315789,24,41.7,0.230769231,Australia-Victoria,2022/05/06,2022/05/06 11:30
4,Avondale FC,11,7,1,3,22,12,5,3,1,1,7,2,6,4,0,2,15,10,22,10,3.09,1.090909091,0.4,1.666666667,2,1.4,2.5,42.76315789,14.47368421,42.76315789,24,45.8,0.307692308,Australia-Victoria,2022/05/06,2022/04/30 06:15
4,Avondale FC,11,7,1,3,22,12,5,3,1,1,7,2,6,4,0,2,15,10,22,10,3.09,1.090909091,0.4,1.666666667,2,1.4,2.5,42.76315789,14.47368421,42.76315789,24,45.8,0.307692308,Australia-Victoria,2022/05/06,2022/05/07 06:15
5,Bentleigh Gr,11,6,1,4,20,14,6,4,1,1,9,3,5,2,0,3,11,11,19,6,3.09,1.272727273,0.5,2.2,1.818181818,1.5,2.2,42.76315789,14.47368421,42.76315789,24,45.8,0.384615385,Australia-Victoria,2022/05/06,2022/04/30 10:45
5,Bentleigh Gr,11,6,1,4,20,14,6,4,1,1,9,3,5,2,0,3,11,11,19,6,3.09,1.272727273,0.5,2.2,1.818181818,1.5,2.2,42.76315789,14.47368421,42.76315789,24,45.8,0.384615385,Australia-Victoria,2022/05/06,2022/04/25 08:30
5,Bentleigh Gr,11,6,1,4,20,14,6,4,1,1,9,3,5,2,0,3,11,11,19,6,3.09,1.272727273,0.5,2.2,1.818181818,1.5,2.2,42.76315789,14.47368421,42.76315789,24,45.8,0.384615385,Australia-Victoria,2022/05/06,2022/05/07 08:30
6,Port Melb,11,5,4,2,14,11,5,3,1,1,5,3,6,2,3,1,9,8,19,3,2.27,1,0.6,1.333333333,1.272727273,1,1.5,42.76315789,14.47368421,42.76315789,24,45.8,0.461538462,Australia-Victoria,2022/05/06,2022/05/07 08:30
6,Port Melb,11,5,4,2,14,11,5,3,1,1,5,3,6,2,3,1,9,8,19,3,2.27,1,0.6,1.333333333,1.272727273,1,1.5,42.76315789,14.47368421,42.76315789,24,45.8,0.461538462,Australia-Victoria,2022/05/06,2022/04/30 09:45
7,Green Gully,11,6,1,4,13,12,6,5,0,1,9,3,5,1,1,3,4,9,19,1,2.27,1.090909091,0.5,1.8,1.181818182,1.5,0.8,42.76315789,14.47368421,42.76315789,24,45.8,0.538461538,Australia-Victoria,2022/05/06,2022/04/29 11:00
7,Green Gully,11,6,1,4,13,12,6,5,0,1,9,3,5,1,1,3,4,9,19,1,2.27,1.090909091,0.5,1.8,1.181818182,1.5,0.8,42.76315789,14.47368421,42.76315789,24,45.8,0.538461538,Australia-Victoria,2022/05/06,2022/05/07 06:00
8,St Albans St,11,5,2,4,13,14,5,1,1,3,5,10,6,4,1,1,8,4,17,-1,2.45,1.272727273,2,0.666666667,1.181818182,1,1.333333333,42.76315789,14.47368421,42.76315789,24,45.8,0.615384615,Australia-Victoria,2022/05/06,2022/05/01 06:00
8,St Albans St,11,5,2,4,13,14,5,1,1,3,5,10,6,4,1,1,8,4,17,-1,2.45,1.272727273,2,0.666666667,1.181818182,1,1.333333333,42.76315789,14.47368421,42.76315789,24,45.8,0.615384615,Australia-Victoria,2022/05/06,2022/05/06 11:30
9,Melb Knights,10,5,0,5,18,16,5,3,0,2,9,9,5,2,0,3,9,7,15,2,3.4,1.6,1.8,1.4,1.8,1.8,1.8,42.76315789,14.47368421,42.76315789,24,41.7,0.692307692,Australia-Victoria,2022/05/06,2022/05/07 09:00
10,Heidelberg U,11,4,0,7,17,18,5,1,0,4,3,9,6,3,0,3,14,9,12,-1,3.18,1.636363636,1.8,1.5,1.545454545,0.6,2.333333333,42.76315789,14.47368421,42.76315789,24,45.8,0.769230769,Australia-Victoria,2022/05/06,2022/04/29 11:00
10,Heidelberg U,11,4,0,7,17,18,5,1,0,4,3,9,6,3,0,3,14,9,12,-1,3.18,1.636363636,1.8,1.5,1.545454545,0.6,2.333333333,42.76315789,14.47368421,42.76315789,24,45.8,0.769230769,Australia-Victoria,2022/05/06,2022/05/07 06:15
11,Altona Magic,11,3,2,6,6,11,5,1,1,3,2,5,6,2,1,3,4,6,11,-5,1.55,1,1,1,0.545454545,0.4,0.666666667,42.76315789,14.47368421,42.76315789,24,45.8,0.846153846,Australia-Victoria,2022/05/06,2022/04/25 09:00
11,Altona Magic,11,3,2,6,6,11,5,1,1,3,2,5,6,2,1,3,4,6,11,-5,1.55,1,1,1,0.545454545,0.4,0.666666667,42.76315789,14.47368421,42.76315789,24,45.8,0.846153846,Australia-Victoria,2022/05/06,2022/05/07 09:00
11,Altona Magic,11,3,2,6,6,11,5,1,1,3,2,5,6,2,1,3,4,6,11,-5,1.55,1,1,1,0.545454545,0.4,0.666666667,42.76315789,14.47368421,42.76315789,24,45.8,0.846153846,Australia-Victoria,2022/05/06,2022/04/30 10:45
12,Hume City,11,1,2,8,10,26,6,1,1,4,9,15,5,0,1,4,1,11,5,-16,3.27,2.363636364,2.5,2.2,0.909090909,1.5,0.2,42.76315789,14.47368421,42.76315789,24,45.8,0.923076923,Australia-Victoria,2022/05/06,2022/04/30 10:00
12,Hume City,11,1,2,8,10,26,6,1,1,4,9,15,5,0,1,4,1,11,5,-16,3.27,2.363636364,2.5,2.2,0.909090909,1.5,0.2,42.76315789,14.47368421,42.76315789,24,45.8,0.923076923,Australia-Victoria,2022/05/06,2022/05/07 10:00
13,Eastern Pride,11,1,1,9,10,29,5,0,0,5,6,16,6,1,1,4,4,13,4,-19,3.55,2.636363636,3.2,2.166666667,0.909090909,1.2,0.666666667,42.76315789,14.47368421,42.76315789,24,45.8,1,Australia-Victoria,2022/05/06,2022/05/07 06:00
13,Eastern Pride,11,1,1,9,10,29,5,0,0,5,6,16,6,1,1,4,4,13,4,-19,3.55,2.636363636,3.2,2.166666667,0.909090909,1.2,0.666666667,42.76315789,14.47368421,42.76315789,24,45.8,1,Australia-Victoria,2022/05/06,2022/04/30 10:00
1,Floreat Ath,6,4,1,1,17,10,3,3,0,0,12,4,3,1,1,1,5,6,13,7,4.5,1.666666667,1.333333333,2,2.833333333,4,1.666666667,39.65517241,20.68965517,39.65517241,22,27.3,0.083333333,Australia-Western-Australia,2022/05/06,2022/04/30 08:00
1,Floreat Ath,6,4,1,1,17,10,3,3,0,0,12,4,3,1,1,1,5,6,13,7,4.5,1.666666667,1.333333333,2,2.833333333,4,1.666666667,39.65517241,20.68965517,39.65517241,22,27.3,0.083333333,Australia-Western-Australia,2022/05/06,2022/04/16 08:00
1,Floreat Ath,6,4,1,1,17,10,3,3,0,0,12,4,3,1,1,1,5,6,13,7,4.5,1.666666667,1.333333333,2,2.833333333,4,1.666666667,39.65517241,20.68965517,39.65517241,22,27.3,0.083333333,Australia-Western-Australia,2022/05/06,2022/05/03 12:00
1,Floreat Ath,6,4,1,1,17,10,3,3,0,0,12,4,3,1,1,1,5,6,13,7,4.5,1.666666667,1.333333333,2,2.833333333,4,1.666666667,39.65517241,20.68965517,39.65517241,22,27.3,0.083333333,Australia-Western-Australia,2022/05/06,2022/05/07 08:00
2,ECU Joondal,6,4,0,2,16,11,3,2,0,1,7,5,3,2,0,1,9,6,12,5,4.5,1.833333333,1.666666667,2,2.666666667,2.333333333,3,39.65517241,20.68965517,39.65517241,22,27.3,0.166666667,Australia-Western-Australia,2022/05/06,2022/05/07 08:00
2,ECU Joondal,6,4,0,2,16,11,3,2,0,1,7,5,3,2,0,1,9,6,12,5,4.5,1.833333333,1.666666667,2,2.666666667,2.333333333,3,39.65517241,20.68965517,39.65517241,22,27.3,0.166666667,Australia-Western-Australia,2022/05/06,2022/04/30 08:00
3,Sorrento,5,3,1,1,13,5,3,2,0,1,8,3,2,1,1,0,5,2,10,8,3.6,1,1,1,2.6,2.666666667,2.5,39.65517241,20.68965517,39.65517241,22,22.7,0.25,Australia-Western-Australia,2022/05/06,2022/05/07 08:00
3,Sorrento,5,3,1,1,13,5,3,2,0,1,8,3,2,1,1,0,5,2,10,8,3.6,1,1,1,2.6,2.666666667,2.5,39.65517241,20.68965517,39.65517241,22,22.7,0.25,Australia-Western-Australia,2022/05/06,2022/04/30 08:00
4,Bayswater Cy,5,3,1,1,12,8,2,0,1,1,4,5,3,3,0,0,8,3,10,4,4,1.6,2.5,1,2.4,2,2.666666667,39.65517241,20.68965517,39.65517241,22,22.7,0.333333333,Australia-Western-Australia,2022/05/06,2022/05/07 08:00
4,Bayswater Cy,5,3,1,1,12,8,2,0,1,1,4,5,3,3,0,0,8,3,10,4,4,1.6,2.5,1,2.4,2,2.666666667,39.65517241,20.68965517,39.65517241,22,22.7,0.333333333,Australia-Western-Australia,2022/05/06,2022/04/30 08:00
4,Bayswater Cy,5,3,1,1,12,8,2,0,1,1,4,5,3,3,0,0,8,3,10,4,4,1.6,2.5,1,2.4,2,2.666666667,39.65517241,20.68965517,39.65517241,22,22.7,0.333333333,Australia-Western-Australia,2022/05/06,2022/05/10 12:00
5,Stirling Mac,4,3,0,1,7,7,2,1,0,1,1,3,2,2,0,0,6,4,9,0,3.5,1.75,1.5,2,1.75,0.5,3,39.65517241,20.68965517,39.65517241,22,18.2,0.416666667,Australia-Western-Australia,2022/05/06,2022/05/08 08:00
6,Perth Gl U21,5,2,2,1,7,5,3,0,2,1,2,4,2,2,0,0,5,1,8,2,2.4,1,1.333333333,0.5,1.4,0.666666667,2.5,39.65517241,20.68965517,39.65517241,22,22.7,0.5,Australia-Western-Australia,2022/05/06,2022/04/29 12:30
6,Perth Gl U21,5,2,2,1,7,5,3,0,2,1,2,4,2,2,0,0,5,1,8,2,2.4,1,1.333333333,0.5,1.4,0.666666667,2.5,39.65517241,20.68965517,39.65517241,22,22.7,0.5,Australia-Western-Australia,2022/05/06,2022/05/06 12:30
6,Perth Gl U21,5,2,2,1,7,5,3,0,2,1,2,4,2,2,0,0,5,1,8,2,2.4,1,1.333333333,0.5,1.4,0.666666667,2.5,39.65517241,20.68965517,39.65517241,22,22.7,0.5,Australia-Western-Australia,2022/05/06,2022/05/10 12:00
7,Inglewood Utd,6,2,1,3,9,8,3,0,1,2,4,6,3,2,0,1,5,2,7,1,2.83,1.333333333,2,0.666666667,1.5,1.333333333,1.666666667,39.65517241,20.68965517,39.65517241,22,27.3,0.583333333,Australia-Western-Australia,2022/05/06,2022/04/30 08:00
7,Inglewood Utd,6,2,1,3,9,8,3,0,1,2,4,6,3,2,0,1,5,2,7,1,2.83,1.333333333,2,0.666666667,1.5,1.333333333,1.666666667,39.65517241,20.68965517,39.65517241,22,27.3,0.583333333,Australia-Western-Australia,2022/05/06,2022/05/07 08:00
8,Cockburn Cy,3,1,1,1,6,6,2,1,0,1,4,4,1,0,1,0,2,2,4,0,4,2,2,2,2,2,2,39.65517241,20.68965517,39.65517241,22,13.6,0.666666667,Australia-Western-Australia,2022/05/06,2022/04/16 08:00
8,Cockburn Cy,3,1,1,1,6,6,2,1,0,1,4,4,1,0,1,0,2,2,4,0,4,2,2,2,2,2,2,39.65517241,20.68965517,39.65517241,22,13.6,0.666666667,Australia-Western-Australia,2022/05/06,2022/05/07 08:00
9,Armadale,5,1,1,3,10,12,3,1,0,2,8,6,2,0,1,1,2,6,4,-2,4.4,2.4,2,3,2,2.666666667,1,39.65517241,20.68965517,39.65517241,22,22.7,0.75,Australia-Western-Australia,2022/05/06,2022/04/19 12:00
9,Armadale,5,1,1,3,10,12,3,1,0,2,8,6,2,0,1,1,2,6,4,-2,4.4,2.4,2,3,2,2.666666667,1,39.65517241,20.68965517,39.65517241,22,22.7,0.75,Australia-Western-Australia,2022/05/06,2022/04/30 08:00
9,Armadale,5,1,1,3,10,12,3,1,0,2,8,6,2,0,1,1,2,6,4,-2,4.4,2.4,2,3,2,2.666666667,1,39.65517241,20.68965517,39.65517241,22,22.7,0.75,Australia-Western-Australia,2022/05/06,2022/05/07 08:00
10,Perth SC,4,0,3,1,2,3,2,0,2,0,2,2,2,0,1,1,0,1,3,-1,1.25,0.75,1,0.5,0.5,1,0,39.65517241,20.68965517,39.65517241,22,18.2,0.833333333,Australia-Western-Australia,2022/05/06,2022/05/03 12:00
10,Perth SC,4,0,3,1,2,3,2,0,2,0,2,2,2,0,1,1,0,1,3,-1,1.25,0.75,1,0.5,0.5,1,0,39.65517241,20.68965517,39.65517241,22,18.2,0.833333333,Australia-Western-Australia,2022/05/06,2022/04/29 12:30
10,Perth SC,4,0,3,1,2,3,2,0,2,0,2,2,2,0,1,1,0,1,3,-1,1.25,0.75,1,0.5,0.5,1,0,39.65517241,20.68965517,39.65517241,22,18.2,0.833333333,Australia-Western-Australia,2022/05/06,2022/05/07 08:00
11,Gwelup Cro,5,0,1,4,5,12,1,0,0,1,0,2,4,0,1,3,5,10,1,-7,3.4,2.4,2,2.5,1,0,1.25,39.65517241,20.68965517,39.65517241,22,22.7,0.916666667,Australia-Western-Australia,2022/05/06,2022/05/08 08:00
11,Gwelup Cro,5,0,1,4,5,12,1,0,0,1,0,2,4,0,1,3,5,10,1,-7,3.4,2.4,2,2.5,1,0,1.25,39.65517241,20.68965517,39.65517241,22,22.7,0.916666667,Australia-Western-Australia,2022/05/06,2022/04/30 08:00
12,Balcatta,4,0,0,4,2,19,2,0,0,2,2,8,2,0,0,2,0,11,0,-17,5.25,4.75,4,5.5,0.5,1,0,39.65517241,20.68965517,39.65517241,22,18.2,1,Australia-Western-Australia,2022/05/06,2022/04/30 08:00
12,Balcatta,4,0,0,4,2,19,2,0,0,2,2,8,2,0,0,2,0,11,0,-17,5.25,4.75,4,5.5,0.5,1,0,39.65517241,20.68965517,39.65517241,22,18.2,1,Australia-Western-Australia,2022/05/06,2022/04/19 12:00
12,Balcatta,4,0,0,4,2,19,2,0,0,2,2,8,2,0,0,2,0,11,0,-17,5.25,4.75,4,5.5,0.5,1,0,39.65517241,20.68965517,39.65517241,22,18.2,1,Australia-Western-Australia,2022/05/06,2022/05/06 12:30
1,Aust Lustenau,27,19,4,4,60,25,13,10,1,2,33,10,14,9,3,2,27,15,61,35,3.15,0.925925926,0.769230769,1.071428571,2.222222222,2.538461538,1.928571429,37.73148148,24.53703704,37.73148148,30,90,0.0625,Austria-1-Liga,2022/05/06,2022/05/08 09:30
1,Aust Lustenau,27,19,4,4,60,25,13,10,1,2,33,10,14,9,3,2,27,15,61,35,3.15,0.925925926,0.769230769,1.071428571,2.222222222,2.538461538,1.928571429,37.73148148,24.53703704,37.73148148,30,90,0.0625,Austria-1-Liga,2022/05/06,2022/04/30 13:30
2,Floridsdorfer,27,18,5,4,46,16,13,9,2,2,25,10,14,9,3,2,21,6,59,30,2.3,0.592592593,0.769230769,0.428571429,1.703703704,1.923076923,1.5,37.73148148,24.53703704,37.73148148,30,90,0.125,Austria-1-Liga,2022/05/06,2022/05/06 19:25
2,Floridsdorfer,27,18,5,4,46,16,13,9,2,2,25,10,14,9,3,2,21,6,59,30,2.3,0.592592593,0.769230769,0.428571429,1.703703704,1.923076923,1.5,37.73148148,24.53703704,37.73148148,30,90,0.125,Austria-1-Liga,2022/05/06,2022/04/29 17:30
3,BW Linz,27,14,8,5,48,25,14,9,4,1,28,12,13,5,4,4,20,13,50,23,2.7,0.925925926,0.857142857,1,1.777777778,2,1.538461538,37.73148148,24.53703704,37.73148148,30,90,0.1875,Austria-1-Liga,2022/05/06,2022/04/30 13:30
3,BW Linz,27,14,8,5,48,25,14,9,4,1,28,12,13,5,4,4,20,13,50,23,2.7,0.925925926,0.857142857,1,1.777777778,2,1.538461538,37.73148148,24.53703704,37.73148148,30,90,0.1875,Austria-1-Liga,2022/05/06,2022/05/06 19:25
4,Amstetten,27,14,6,7,54,29,13,8,4,1,25,9,14,6,2,6,29,20,48,25,3.07,1.074074074,0.692307692,1.428571429,2,1.923076923,2.071428571,37.73148148,24.53703704,37.73148148,30,90,0.25,Austria-1-Liga,2022/05/06,2022/05/06 17:30
4,Amstetten,27,14,6,7,54,29,13,8,4,1,25,9,14,6,2,6,29,20,48,25,3.07,1.074074074,0.692307692,1.428571429,2,1.923076923,2.071428571,37.73148148,24.53703704,37.73148148,30,90,0.25,Austria-1-Liga,2022/05/06,2022/04/29 17:30
5,Lafnitz,27,13,7,7,48,38,14,9,2,3,29,21,13,4,5,4,19,17,46,10,3.19,1.407407407,1.5,1.307692308,1.777777778,2.071428571,1.461538462,37.73148148,24.53703704,37.73148148,30,90,0.3125,Austria-1-Liga,2022/05/06,2022/04/29 17:30
5,Lafnitz,27,13,7,7,48,38,14,9,2,3,29,21,13,4,5,4,19,17,46,10,3.19,1.407407407,1.5,1.307692308,1.777777778,2.071428571,1.461538462,37.73148148,24.53703704,37.73148148,30,90,0.3125,Austria-1-Liga,2022/05/06,2022/05/06 17:30
6,FC Liefering,27,11,10,6,51,37,14,5,7,2,23,17,13,6,3,4,28,20,43,14,3.26,1.37037037,1.214285714,1.538461538,1.888888889,1.642857143,2.153846154,37.73148148,24.53703704,37.73148148,30,90,0.375,Austria-1-Liga,2022/05/06,2022/05/03 17:30
6,FC Liefering,27,11,10,6,51,37,14,5,7,2,23,17,13,6,3,4,28,20,43,14,3.26,1.37037037,1.214285714,1.538461538,1.888888889,1.642857143,2.153846154,37.73148148,24.53703704,37.73148148,30,90,0.375,Austria-1-Liga,2022/05/06,2022/05/06 17:30
7,Graz AK,27,11,7,9,41,35,13,6,4,3,19,14,14,5,3,6,22,21,40,6,2.81,1.296296296,1.076923077,1.5,1.518518519,1.461538462,1.571428571,37.73148148,24.53703704,37.73148148,30,90,0.4375,Austria-1-Liga,2022/05/06,2022/05/07 13:00
8,Sankt Poelten,27,11,6,10,40,32,14,6,4,4,26,16,13,5,2,6,14,16,39,8,2.67,1.185185185,1.142857143,1.230769231,1.481481481,1.857142857,1.076923077,37.73148148,24.53703704,37.73148148,30,90,0.5,Austria-1-Liga,2022/05/06,2022/05/08 09:30
9,Wacker Innsb,27,10,7,10,40,35,13,5,4,4,20,15,14,5,3,6,20,20,37,5,2.78,1.296296296,1.153846154,1.428571429,1.481481481,1.538461538,1.428571429,37.73148148,24.53703704,37.73148148,30,90,0.5625,Austria-1-Liga,2022/05/06,2022/05/06 17:30
9,Wacker Innsb,27,10,7,10,40,35,13,5,4,4,20,15,14,5,3,6,20,20,37,5,2.78,1.296296296,1.153846154,1.428571429,1.481481481,1.538461538,1.428571429,37.73148148,24.53703704,37.73148148,30,90,0.5625,Austria-1-Liga,2022/05/06,2022/04/29 17:30
10,Rapid Wien 2,27,7,8,12,37,54,13,3,4,6,13,25,14,4,4,6,24,29,29,-17,3.37,2,1.923076923,2.071428571,1.37037037,1,1.714285714,37.73148148,24.53703704,37.73148148,30,90,0.625,Austria-1-Liga,2022/05/06,2022/05/06 17:30
10,Rapid Wien 2,27,7,8,12,37,54,13,3,4,6,13,25,14,4,4,6,24,29,29,-17,3.37,2,1.923076923,2.071428571,1.37037037,1,1.714285714,37.73148148,24.53703704,37.73148148,30,90,0.625,Austria-1-Liga,2022/05/06,2022/04/30 13:30
11,Steyr,27,7,7,13,32,49,13,5,3,5,19,22,14,2,4,8,13,27,28,-17,3,1.814814815,1.692307692,1.928571429,1.185185185,1.461538462,0.928571429,37.73148148,24.53703704,37.73148148,30,90,0.6875,Austria-1-Liga,2022/05/06,2022/05/06 17:30
11,Steyr,27,7,7,13,32,49,13,5,3,5,19,22,14,2,4,8,13,27,28,-17,3,1.814814815,1.692307692,1.928571429,1.185185185,1.461538462,0.928571429,37.73148148,24.53703704,37.73148148,30,90,0.6875,Austria-1-Liga,2022/05/06,2022/04/29 17:30
12,SV Horn,27,6,7,14,29,47,14,4,2,8,13,22,13,2,5,6,16,25,25,-18,2.81,1.740740741,1.571428571,1.923076923,1.074074074,0.928571429,1.230769231,37.73148148,24.53703704,37.73148148,30,90,0.75,Austria-1-Liga,2022/05/06,2022/04/29 17:30
12,SV Horn,27,6,7,14,29,47,14,4,2,8,13,22,13,2,5,6,16,25,25,-18,2.81,1.740740741,1.571428571,1.923076923,1.074074074,0.928571429,1.230769231,37.73148148,24.53703704,37.73148148,30,90,0.75,Austria-1-Liga,2022/05/06,2022/05/06 17:30
13,Kapfenberg,27,7,4,16,30,52,13,4,2,7,14,18,14,3,2,9,16,34,25,-22,3.04,1.925925926,1.384615385,2.428571429,1.111111111,1.076923077,1.142857143,37.73148148,24.53703704,37.73148148,30,90,0.8125,Austria-1-Liga,2022/05/06,2022/05/06 17:30
14,Aust Wien Am,27,6,6,15,27,44,14,2,3,9,12,27,13,4,3,6,15,17,24,-17,2.63,1.62962963,1.928571429,1.307692308,1,0.857142857,1.153846154,37.73148148,24.53703704,37.73148148,30,90,0.875,Austria-1-Liga,2022/05/06,2022/04/29 17:30
14,Aust Wien Am,27,6,6,15,27,44,14,2,3,9,12,27,13,4,3,6,15,17,24,-17,2.63,1.62962963,1.928571429,1.307692308,1,0.857142857,1.153846154,37.73148148,24.53703704,37.73148148,30,90,0.875,Austria-1-Liga,2022/05/06,2022/05/06 17:30
15,Dornbirn,27,6,4,17,33,65,14,4,3,7,20,32,13,2,1,10,13,33,22,-32,3.63,2.407407407,2.285714286,2.538461538,1.222222222,1.428571429,1,37.73148148,24.53703704,37.73148148,30,90,0.9375,Austria-1-Liga,2022/05/06,2022/04/30 13:30
15,Dornbirn,27,6,4,17,33,65,14,4,3,7,20,32,13,2,1,10,13,33,22,-32,3.63,2.407407407,2.285714286,2.538461538,1.222222222,1.428571429,1,37.73148148,24.53703704,37.73148148,30,90,0.9375,Austria-1-Liga,2022/05/06,2022/05/07 13:00
16,Juniors OO,27,3,10,14,34,67,14,3,4,7,25,36,13,0,6,7,9,31,19,-33,3.74,2.481481481,2.571428571,2.384615385,1.259259259,1.785714286,0.692307692,37.73148148,24.53703704,37.73148148,30,90,1,Austria-1-Liga,2022/05/06,2022/04/29 17:30
16,Juniors OO,27,3,10,14,34,67,14,3,4,7,25,36,13,0,6,7,9,31,19,-33,3.74,2.481481481,2.571428571,2.384615385,1.259259259,1.785714286,0.692307692,37.73148148,24.53703704,37.73148148,30,90,1,Austria-1-Liga,2022/05/06,2022/05/03 17:30
16,Juniors OO,27,3,10,14,34,67,14,3,4,7,25,36,13,0,6,7,9,31,19,-33,3.74,2.481481481,2.571428571,2.384615385,1.259259259,1.785714286,0.692307692,37.73148148,24.53703704,37.73148148,30,90,1,Austria-1-Liga,2022/05/06,2022/05/06 17:30
1,Sturm Graz 2,26,18,5,3,86,26,13,9,3,1,50,16,13,9,2,2,36,10,59,60,4.31,1,1.230769231,0.769230769,3.307692308,3.846153846,2.769230769,37.73148148,24.53703704,37.73148148,32,81.2,0.058823529,Austria-Regionalliga-Mitte,2022/05/06,2022/04/29 18:00
2,Deut.berger,25,14,7,4,45,20,13,7,4,2,28,13,12,7,3,2,17,7,49,25,2.6,0.8,1,0.583333333,1.8,2.153846154,1.416666667,37.73148148,24.53703704,37.73148148,32,78.1,0.117647059,Austria-Regionalliga-Mitte,2022/05/06,2022/04/29 18:00
2,Deut.berger,25,14,7,4,45,20,13,7,4,2,28,13,12,7,3,2,17,7,49,25,2.6,0.8,1,0.583333333,1.8,2.153846154,1.416666667,37.73148148,24.53703704,37.73148148,32,78.1,0.117647059,Austria-Regionalliga-Mitte,2022/05/06,2022/05/06 18:30
3,Gurten,26,14,7,5,50,28,13,9,2,2,28,11,13,5,5,3,22,17,49,22,3,1.076923077,0.846153846,1.307692308,1.923076923,2.153846154,1.692307692,37.73148148,24.53703704,37.73148148,32,81.2,0.176470588,Austria-Regionalliga-Mitte,2022/05/06,2022/05/07 15:00
4,Bad Gleichen,26,13,8,5,46,31,12,6,4,2,18,10,14,7,4,3,28,21,47,15,2.96,1.192307692,0.833333333,1.5,1.769230769,1.5,2,37.73148148,24.53703704,37.73148148,32,81.2,0.235294118,Austria-Regionalliga-Mitte,2022/05/06,2022/05/06 18:00
4,Bad Gleichen,26,13,8,5,46,31,12,6,4,2,18,10,14,7,4,3,28,21,47,15,2.96,1.192307692,0.833333333,1.5,1.769230769,1.5,2,37.73148148,24.53703704,37.73148148,32,81.2,0.235294118,Austria-Regionalliga-Mitte,2022/05/06,2022/04/29 18:00
4,Bad Gleichen,26,13,8,5,46,31,12,6,4,2,18,10,14,7,4,3,28,21,47,15,2.96,1.192307692,0.833333333,1.5,1.769230769,1.5,2,37.73148148,24.53703704,37.73148148,32,81.2,0.235294118,Austria-Regionalliga-Mitte,2022/05/06,2022/05/03 18:00
5,Hertha Wels,26,13,7,6,49,24,13,7,3,3,26,11,13,6,4,3,23,13,46,25,2.81,0.923076923,0.846153846,1,1.884615385,2,1.769230769,37.73148148,24.53703704,37.73148148,32,81.2,0.294117647,Austria-Regionalliga-Mitte,2022/05/06,2022/05/06 18:30
5,Hertha Wels,26,13,7,6,49,24,13,7,3,3,26,11,13,6,4,3,23,13,46,25,2.81,0.923076923,0.846153846,1,1.884615385,2,1.769230769,37.73148148,24.53703704,37.73148148,32,81.2,0.294117647,Austria-Regionalliga-Mitte,2022/05/06,2022/04/29 18:00
6,Un Vocklama,25,13,4,8,38,33,13,8,2,3,24,14,12,5,2,5,14,19,43,5,2.84,1.32,1.076923077,1.583333333,1.52,1.846153846,1.166666667,37.73148148,24.53703704,37.73148148,32,78.1,0.352941176,Austria-Regionalliga-Mitte,2022/05/06,2022/05/06 18:00
7,Wolfsberger 2,25,10,9,6,50,41,14,6,5,3,23,18,11,4,4,3,27,23,39,9,3.64,1.64,1.285714286,2.090909091,2,1.642857143,2.454545455,37.73148148,24.53703704,37.73148148,32,78.1,0.411764706,Austria-Regionalliga-Mitte,2022/05/06,2022/04/30 13:30
7,Wolfsberger 2,25,10,9,6,50,41,14,6,5,3,23,18,11,4,4,3,27,23,39,9,3.64,1.64,1.285714286,2.090909091,2,1.642857143,2.454545455,37.73148148,24.53703704,37.73148148,32,78.1,0.411764706,Austria-Regionalliga-Mitte,2022/05/06,2022/05/06 18:00
8,Gleisdorf,25,9,9,7,37,39,13,4,5,4,16,25,12,5,4,3,21,14,36,-2,3.04,1.56,1.923076923,1.166666667,1.48,1.230769231,1.75,37.73148148,24.53703704,37.73148148,32,78.1,0.470588235,Austria-Regionalliga-Mitte,2022/05/06,2022/05/07 15:00
9,SC Weiz,25,11,3,11,38,42,13,7,2,4,24,21,12,4,1,7,14,21,36,-4,3.2,1.68,1.615384615,1.75,1.52,1.846153846,1.166666667,37.73148148,24.53703704,37.73148148,32,78.1,0.529411765,Austria-Regionalliga-Mitte,2022/05/06,2022/04/29 18:00
9,SC Weiz,25,11,3,11,38,42,13,7,2,4,24,21,12,4,1,7,14,21,36,-4,3.2,1.68,1.615384615,1.75,1.52,1.846153846,1.166666667,37.73148148,24.53703704,37.73148148,32,78.1,0.529411765,Austria-Regionalliga-Mitte,2022/05/06,2022/05/06 18:00
10,Allerheilign,25,8,10,7,40,41,13,5,5,3,23,22,12,3,5,4,17,19,34,-1,3.24,1.64,1.692307692,1.583333333,1.6,1.769230769,1.416666667,37.73148148,24.53703704,37.73148148,32,78.1,0.588235294,Austria-Regionalliga-Mitte,2022/05/06,2022/04/29 18:00
10,Allerheilign,25,8,10,7,40,41,13,5,5,3,23,22,12,3,5,4,17,19,34,-1,3.24,1.64,1.692307692,1.583333333,1.6,1.769230769,1.416666667,37.73148148,24.53703704,37.73148148,32,78.1,0.588235294,Austria-Regionalliga-Mitte,2022/05/06,2022/05/07 16:00
11,Neuhofen,26,8,8,10,46,47,12,4,4,4,26,20,14,4,4,6,20,27,32,-1,3.58,1.807692308,1.666666667,1.928571429,1.769230769,2.166666667,1.428571429,37.73148148,24.53703704,37.73148148,32,81.2,0.647058824,Austria-Regionalliga-Mitte,2022/05/06,2022/05/03 18:00
11,Neuhofen,26,8,8,10,46,47,12,4,4,4,26,20,14,4,4,6,20,27,32,-1,3.58,1.807692308,1.666666667,1.928571429,1.769230769,2.166666667,1.428571429,37.73148148,24.53703704,37.73148148,32,81.2,0.647058824,Austria-Regionalliga-Mitte,2022/05/06,2022/05/06 18:00
11,Neuhofen,26,8,8,10,46,47,12,4,4,4,26,20,14,4,4,6,20,27,32,-1,3.58,1.807692308,1.666666667,1.928571429,1.769230769,2.166666667,1.428571429,37.73148148,24.53703704,37.73148148,32,81.2,0.647058824,Austria-Regionalliga-Mitte,2022/05/06,2022/04/29 18:00
12,Wein St Anna,25,7,8,10,39,41,13,4,4,5,24,23,12,3,4,5,15,18,29,-2,3.2,1.64,1.769230769,1.5,1.56,1.846153846,1.25,37.73148148,24.53703704,37.73148148,32,78.1,0.705882353,Austria-Regionalliga-Mitte,2022/05/06,2022/05/06 18:00
13,Kalsdorf,26,8,5,13,36,46,12,5,1,6,14,15,14,3,4,7,22,31,29,-10,3.15,1.769230769,1.25,2.214285714,1.384615385,1.166666667,1.571428571,37.73148148,24.53703704,37.73148148,32,81.2,0.764705882,Austria-Regionalliga-Mitte,2022/05/06,2022/05/06 18:00
14,Treibach,26,7,5,14,47,56,13,4,3,6,25,30,13,3,2,8,22,26,26,-9,3.96,2.153846154,2.307692308,2,1.807692308,1.923076923,1.692307692,37.73148148,24.53703704,37.73148148,32,81.2,0.823529412,Austria-Regionalliga-Mitte,2022/05/06,2022/05/03 18:00
14,Treibach,26,7,5,14,47,56,13,4,3,6,25,30,13,3,2,8,22,26,26,-9,3.96,2.153846154,2.307692308,2,1.807692308,1.923076923,1.692307692,37.73148148,24.53703704,37.73148148,32,81.2,0.823529412,Austria-Regionalliga-Mitte,2022/05/06,2022/05/06 18:00
14,Treibach,26,7,5,14,47,56,13,4,3,6,25,30,13,3,2,8,22,26,26,-9,3.96,2.153846154,2.307692308,2,1.807692308,1.923076923,1.692307692,37.73148148,24.53703704,37.73148148,32,81.2,0.823529412,Austria-Regionalliga-Mitte,2022/05/06,2022/04/30 13:30
15,FC Wels,25,5,3,17,33,60,14,4,3,7,20,28,11,1,0,10,13,32,18,-27,3.72,2.4,2,2.909090909,1.32,1.428571429,1.181818182,37.73148148,24.53703704,37.73148148,32,78.1,0.882352941,Austria-Regionalliga-Mitte,2022/05/06,2022/05/06 18:00
16,Spittal Drau,25,4,5,16,20,43,10,2,2,6,7,16,15,2,3,10,13,27,17,-23,2.52,1.72,1.6,1.8,0.8,0.7,0.866666667,37.73148148,24.53703704,37.73148148,32,78.1,0.941176471,Austria-Regionalliga-Mitte,2022/05/06,2022/05/06 18:00
16,Spittal Drau,25,4,5,16,20,43,10,2,2,6,7,16,15,2,3,10,13,27,17,-23,2.52,1.72,1.6,1.8,0.8,0.7,0.866666667,37.73148148,24.53703704,37.73148148,32,78.1,0.941176471,Austria-Regionalliga-Mitte,2022/05/06,2022/04/29 18:00
16,Spittal Drau,25,4,5,16,20,43,10,2,2,6,7,16,15,2,3,10,13,27,17,-23,2.52,1.72,1.6,1.8,0.8,0.7,0.866666667,37.73148148,24.53703704,37.73148148,32,78.1,0.941176471,Austria-Regionalliga-Mitte,2022/05/06,2022/05/03 18:00
17,Stadl Paura,25,1,3,21,15,97,12,1,1,10,9,37,13,0,2,11,6,60,6,-82,4.48,3.88,3.083333333,4.615384615,0.6,0.75,0.461538462,37.73148148,24.53703704,37.73148148,32,78.1,1,Austria-Regionalliga-Mitte,2022/05/06,2022/05/07 16:00
1,First Vienna,22,15,5,2,45,15,11,7,2,2,19,9,11,8,3,0,26,6,50,30,2.73,0.681818182,0.818181818,0.545454545,2.045454545,1.727272727,2.363636364,37.66233766,24.67532468,37.66233766,26,84.6,0.071428571,Austria-Regionalliga-Ost,2022/05/06,2022/04/29 18:30
1,First Vienna,22,15,5,2,45,15,11,7,2,2,19,9,11,8,3,0,26,6,50,30,2.73,0.681818182,0.818181818,0.545454545,2.045454545,1.727272727,2.363636364,37.66233766,24.67532468,37.66233766,26,84.6,0.071428571,Austria-Regionalliga-Ost,2022/05/06,2022/05/07 15:30
2,Stripfing,22,12,9,1,51,15,12,6,6,0,26,10,10,6,3,1,25,5,45,36,3,0.681818182,0.833333333,0.5,2.318181818,2.166666667,2.5,37.66233766,24.67532468,37.66233766,26,84.6,0.142857143,Austria-Regionalliga-Ost,2022/05/06,2022/04/30 15:30
2,Stripfing,22,12,9,1,51,15,12,6,6,0,26,10,10,6,3,1,25,5,45,36,3,0.681818182,0.833333333,0.5,2.318181818,2.166666667,2.5,37.66233766,24.67532468,37.66233766,26,84.6,0.142857143,Austria-Regionalliga-Ost,2022/05/06,2022/05/08 13:00
3,Wiener Linien,22,12,4,6,31,25,11,6,2,3,13,10,11,6,2,3,18,15,40,6,2.55,1.136363636,0.909090909,1.363636364,1.409090909,1.181818182,1.636363636,37.66233766,24.67532468,37.66233766,26,84.6,0.214285714,Austria-Regionalliga-Ost,2022/05/06,2022/05/06 18:30
3,Wiener Linien,22,12,4,6,31,25,11,6,2,3,13,10,11,6,2,3,18,15,40,6,2.55,1.136363636,0.909090909,1.363636364,1.409090909,1.181818182,1.636363636,37.66233766,24.67532468,37.66233766,26,84.6,0.214285714,Austria-Regionalliga-Ost,2022/05/06,2022/04/30 17:00
4,Leobendorf,22,11,6,5,40,30,10,4,4,2,14,14,12,7,2,3,26,16,39,10,3.18,1.363636364,1.4,1.333333333,1.818181818,1.4,2.166666667,37.66233766,24.67532468,37.66233766,26,84.6,0.285714286,Austria-Regionalliga-Ost,2022/05/06,2022/05/07 15:30
4,Leobendorf,22,11,6,5,40,30,10,4,4,2,14,14,12,7,2,3,26,16,39,10,3.18,1.363636364,1.4,1.333333333,1.818181818,1.4,2.166666667,37.66233766,24.67532468,37.66233766,26,84.6,0.285714286,Austria-Regionalliga-Ost,2022/05/06,2022/04/29 18:00
5,Wiener SK,22,10,6,6,41,28,11,5,3,3,25,14,11,5,3,3,16,14,36,13,3.14,1.272727273,1.272727273,1.272727273,1.863636364,2.272727273,1.454545455,37.66233766,24.67532468,37.66233766,26,84.6,0.357142857,Austria-Regionalliga-Ost,2022/05/06,2022/05/06 18:30
5,Wiener SK,22,10,6,6,41,28,11,5,3,3,25,14,11,5,3,3,16,14,36,13,3.14,1.272727273,1.272727273,1.272727273,1.863636364,2.272727273,1.454545455,37.66233766,24.67532468,37.66233766,26,84.6,0.357142857,Austria-Regionalliga-Ost,2022/05/06,2022/04/29 18:30
6,Neusiedl See,22,10,4,8,33,33,11,3,2,6,12,19,11,7,2,2,21,14,34,0,3,1.5,1.727272727,1.272727273,1.5,1.090909091,1.909090909,37.66233766,24.67532468,37.66233766,26,84.6,0.428571429,Austria-Regionalliga-Ost,2022/05/06,2022/04/29 18:00
6,Neusiedl See,22,10,4,8,33,33,11,3,2,6,12,19,11,7,2,2,21,14,34,0,3,1.5,1.727272727,1.272727273,1.5,1.090909091,1.909090909,37.66233766,24.67532468,37.66233766,26,84.6,0.428571429,Austria-Regionalliga-Ost,2022/05/06,2022/05/03 18:30
6,Neusiedl See,22,10,4,8,33,33,11,3,2,6,12,19,11,7,2,2,21,14,34,0,3,1.5,1.727272727,1.272727273,1.5,1.090909091,1.909090909,37.66233766,24.67532468,37.66233766,26,84.6,0.428571429,Austria-Regionalliga-Ost,2022/05/06,2022/05/06 18:30
7,Marchfeld,22,8,9,5,36,33,10,3,4,3,20,20,12,5,5,2,16,13,33,3,3.14,1.5,2,1.083333333,1.636363636,2,1.333333333,37.66233766,24.67532468,37.66233766,26,84.6,0.5,Austria-Regionalliga-Ost,2022/05/06,2022/05/06 18:30
7,Marchfeld,22,8,9,5,36,33,10,3,4,3,20,20,12,5,5,2,16,13,33,3,3.14,1.5,2,1.083333333,1.636363636,2,1.333333333,37.66233766,24.67532468,37.66233766,26,84.6,0.5,Austria-Regionalliga-Ost,2022/05/06,2022/04/29 18:30
8,Traiskirchen,22,9,5,8,38,36,11,3,1,7,14,20,11,6,4,1,24,16,32,2,3.36,1.636363636,1.818181818,1.454545455,1.727272727,1.272727273,2.181818182,37.66233766,24.67532468,37.66233766,26,84.6,0.571428571,Austria-Regionalliga-Ost,2022/05/06,2022/04/29 17:30
8,Traiskirchen,22,9,5,8,38,36,11,3,1,7,14,20,11,6,4,1,24,16,32,2,3.36,1.636363636,1.818181818,1.454545455,1.727272727,1.272727273,2.181818182,37.66233766,24.67532468,37.66233766,26,84.6,0.571428571,Austria-Regionalliga-Ost,2022/05/06,2022/05/03 18:30
8,Traiskirchen,22,9,5,8,38,36,11,3,1,7,14,20,11,6,4,1,24,16,32,2,3.36,1.636363636,1.818181818,1.454545455,1.727272727,1.272727273,2.181818182,37.66233766,24.67532468,37.66233766,26,84.6,0.571428571,Austria-Regionalliga-Ost,2022/05/06,2022/05/06 18:30
9,Wiener Vikt,22,8,4,10,31,36,11,5,2,4,21,15,11,3,2,6,10,21,28,-5,3.05,1.636363636,1.363636364,1.909090909,1.409090909,1.909090909,0.909090909,37.66233766,24.67532468,37.66233766,26,84.6,0.642857143,Austria-Regionalliga-Ost,2022/05/06,2022/05/07 15:00
9,Wiener Vikt,22,8,4,10,31,36,11,5,2,4,21,15,11,3,2,6,10,21,28,-5,3.05,1.636363636,1.363636364,1.909090909,1.409090909,1.909090909,0.909090909,37.66233766,24.67532468,37.66233766,26,84.6,0.642857143,Austria-Regionalliga-Ost,2022/05/06,2022/04/30 15:30
10,ASK BSC,22,6,7,9,39,36,11,5,2,4,27,18,11,1,5,5,12,18,25,3,3.41,1.636363636,1.636363636,1.636363636,1.772727273,2.454545455,1.090909091,37.66233766,24.67532468,37.66233766,26,84.6,0.714285714,Austria-Regionalliga-Ost,2022/05/06,2022/05/06 18:00
10,ASK BSC,22,6,7,9,39,36,11,5,2,4,27,18,11,1,5,5,12,18,25,3,3.41,1.636363636,1.636363636,1.636363636,1.772727273,2.454545455,1.090909091,37.66233766,24.67532468,37.66233766,26,84.6,0.714285714,Austria-Regionalliga-Ost,2022/05/06,2022/04/29 17:30
11,FC Mauerwerk,22,5,4,13,25,50,11,4,2,5,11,16,11,1,2,8,14,34,19,-25,3.41,2.272727273,1.454545455,3.090909091,1.136363636,1,1.272727273,37.66233766,24.67532468,37.66233766,26,84.6,0.785714286,Austria-Regionalliga-Ost,2022/05/06,2022/04/30 17:00
11,FC Mauerwerk,22,5,4,13,25,50,11,4,2,5,11,16,11,1,2,8,14,34,19,-25,3.41,2.272727273,1.454545455,3.090909091,1.136363636,1,1.272727273,37.66233766,24.67532468,37.66233766,26,84.6,0.785714286,Austria-Regionalliga-Ost,2022/05/06,2022/05/06 18:00
12,Admira 2,22,4,6,12,27,42,11,3,4,4,17,22,11,1,2,8,10,20,18,-15,3.14,1.909090909,2,1.818181818,1.227272727,1.545454545,0.909090909,37.66233766,24.67532468,37.66233766,26,84.6,0.857142857,Austria-Regionalliga-Ost,2022/05/06,2022/05/08 13:00
12,Admira 2,22,4,6,12,27,42,11,3,4,4,17,22,11,1,2,8,10,20,18,-15,3.14,1.909090909,2,1.818181818,1.227272727,1.545454545,0.909090909,37.66233766,24.67532468,37.66233766,26,84.6,0.857142857,Austria-Regionalliga-Ost,2022/05/06,2022/04/29 19:00
13,Drabburg,22,3,4,15,17,47,12,2,3,7,11,24,10,1,1,8,6,23,13,-30,2.91,2.136363636,2,2.3,0.772727273,0.916666667,0.6,37.66233766,24.67532468,37.66233766,26,84.6,0.928571429,Austria-Regionalliga-Ost,2022/05/06,2022/04/29 18:30
13,Drabburg,22,3,4,15,17,47,12,2,3,7,11,24,10,1,1,8,6,23,13,-30,2.91,2.136363636,2,2.3,0.772727273,0.916666667,0.6,37.66233766,24.67532468,37.66233766,26,84.6,0.928571429,Austria-Regionalliga-Ost,2022/05/06,2022/05/07 15:00
14,Wiener Neust,22,3,3,16,22,50,11,2,1,8,11,24,11,1,2,8,11,26,12,-28,3.27,2.272727273,2.181818182,2.363636364,1,1,1,37.66233766,24.67532468,37.66233766,26,84.6,1,Austria-Regionalliga-Ost,2022/05/06,2022/04/29 19:00
14,Wiener Neust,22,3,3,16,22,50,11,2,1,8,11,24,11,1,2,8,11,26,12,-28,3.27,2.272727273,2.181818182,2.363636364,1,1,1,37.66233766,24.67532468,37.66233766,26,84.6,1,Austria-Regionalliga-Ost,2022/05/06,2022/05/06 18:30
1,Seekirchen,7,4,3,0,13,6,3,2,1,0,7,3,4,2,2,0,6,3,15,7,2.71,0.857142857,1,0.75,1.857142857,2.333333333,1.5,29.31034483,41.37931034,29.31034483,14,50,0.125,Austria-Regionalliga-West-Salzburg,2022/05/06,2022/04/30 15:00
1,Seekirchen,7,4,3,0,13,6,3,2,1,0,7,3,4,2,2,0,6,3,15,7,2.71,0.857142857,1,0.75,1.857142857,2.333333333,1.5,29.31034483,41.37931034,29.31034483,14,50,0.125,Austria-Regionalliga-West-Salzburg,2022/05/06,2022/05/06 18:00
1,Seekirchen,7,4,3,0,13,6,3,2,1,0,7,3,4,2,2,0,6,3,15,7,2.71,0.857142857,1,0.75,1.857142857,2.333333333,1.5,29.31034483,41.37931034,29.31034483,14,50,0.125,Austria-Regionalliga-West-Salzburg,2022/05/06,2022/04/23 15:00
2,Salzburg AK,8,4,3,1,14,8,5,2,3,0,9,4,3,2,0,1,5,4,15,6,2.75,1,0.8,1.333333333,1.75,1.8,1.666666667,29.31034483,41.37931034,29.31034483,14,57.1,0.25,Austria-Regionalliga-West-Salzburg,2022/05/06,2022/04/18 15:00
2,Salzburg AK,8,4,3,1,14,8,5,2,3,0,9,4,3,2,0,1,5,4,15,6,2.75,1,0.8,1.333333333,1.75,1.8,1.666666667,29.31034483,41.37931034,29.31034483,14,57.1,0.25,Austria-Regionalliga-West-Salzburg,2022/05/06,2022/04/30 15:00
2,Salzburg AK,8,4,3,1,14,8,5,2,3,0,9,4,3,2,0,1,5,4,15,6,2.75,1,0.8,1.333333333,1.75,1.8,1.666666667,29.31034483,41.37931034,29.31034483,14,57.1,0.25,Austria-Regionalliga-West-Salzburg,2022/05/06,2022/04/23 15:00
2,Salzburg AK,8,4,3,1,14,8,5,2,3,0,9,4,3,2,0,1,5,4,15,6,2.75,1,0.8,1.333333333,1.75,1.8,1.666666667,29.31034483,41.37931034,29.31034483,14,57.1,0.25,Austria-Regionalliga-West-Salzburg,2022/05/06,2022/05/06 18:00
3,SV Grodig,8,2,4,2,11,10,6,2,2,2,9,8,2,0,2,0,2,2,10,1,2.62,1.25,1.333333333,1,1.375,1.5,1,29.31034483,41.37931034,29.31034483,14,57.1,0.375,Austria-Regionalliga-West-Salzburg,2022/05/06,2022/04/18 15:00
3,SV Grodig,8,2,4,2,11,10,6,2,2,2,9,8,2,0,2,0,2,2,10,1,2.62,1.25,1.333333333,1,1.375,1.5,1,29.31034483,41.37931034,29.31034483,14,57.1,0.375,Austria-Regionalliga-West-Salzburg,2022/05/06,2022/04/30 15:00
3,SV Grodig,8,2,4,2,11,10,6,2,2,2,9,8,2,0,2,0,2,2,10,1,2.62,1.25,1.333333333,1,1.375,1.5,1,29.31034483,41.37931034,29.31034483,14,57.1,0.375,Austria-Regionalliga-West-Salzburg,2022/05/06,2022/04/22 18:00
3,SV Grodig,8,2,4,2,11,10,6,2,2,2,9,8,2,0,2,0,2,2,10,1,2.62,1.25,1.333333333,1,1.375,1.5,1,29.31034483,41.37931034,29.31034483,14,57.1,0.375,Austria-Regionalliga-West-Salzburg,2022/05/06,2022/05/06 18:00
4,Kuchl,8,2,4,2,10,12,3,2,1,0,5,3,5,0,3,2,5,9,10,-2,2.75,1.5,1,1.8,1.25,1.666666667,1,29.31034483,41.37931034,29.31034483,14,57.1,0.5,Austria-Regionalliga-West-Salzburg,2022/05/06,2022/04/23 16:00
4,Kuchl,8,2,4,2,10,12,3,2,1,0,5,3,5,0,3,2,5,9,10,-2,2.75,1.5,1,1.8,1.25,1.666666667,1,29.31034483,41.37931034,29.31034483,14,57.1,0.5,Austria-Regionalliga-West-Salzburg,2022/05/06,2022/05/06 18:00
4,Kuchl,8,2,4,2,10,12,3,2,1,0,5,3,5,0,3,2,5,9,10,-2,2.75,1.5,1,1.8,1.25,1.666666667,1,29.31034483,41.37931034,29.31034483,14,57.1,0.5,Austria-Regionalliga-West-Salzburg,2022/05/06,2022/04/18 15:00
4,Kuchl,8,2,4,2,10,12,3,2,1,0,5,3,5,0,3,2,5,9,10,-2,2.75,1.5,1,1.8,1.25,1.666666667,1,29.31034483,41.37931034,29.31034483,14,57.1,0.5,Austria-Regionalliga-West-Salzburg,2022/05/06,2022/04/30 15:00
5,Pinz Saalf,7,2,2,3,11,11,4,2,0,2,8,7,3,0,2,1,3,4,8,0,3.14,1.571428571,1.75,1.333333333,1.571428571,2,1,29.31034483,41.37931034,29.31034483,14,50,0.625,Austria-Regionalliga-West-Salzburg,2022/05/06,2022/04/18 17:00
5,Pinz Saalf,7,2,2,3,11,11,4,2,0,2,8,7,3,0,2,1,3,4,8,0,3.14,1.571428571,1.75,1.333333333,1.571428571,2,1,29.31034483,41.37931034,29.31034483,14,50,0.625,Austria-Regionalliga-West-Salzburg,2022/05/06,2022/04/30 15:00
5,Pinz Saalf,7,2,2,3,11,11,4,2,0,2,8,7,3,0,2,1,3,4,8,0,3.14,1.571428571,1.75,1.333333333,1.571428571,2,1,29.31034483,41.37931034,29.31034483,14,50,0.625,Austria-Regionalliga-West-Salzburg,2022/05/06,2022/05/07 16:00
5,Pinz Saalf,7,2,2,3,11,11,4,2,0,2,8,7,3,0,2,1,3,4,8,0,3.14,1.571428571,1.75,1.333333333,1.571428571,2,1,29.31034483,41.37931034,29.31034483,14,50,0.625,Austria-Regionalliga-West-Salzburg,2022/05/06,2022/04/23 16:00
6,Salzburg 2,7,2,2,3,7,9,2,1,1,0,3,1,5,1,1,3,4,8,8,-2,2.29,1.285714286,0.5,1.6,1,1.5,0.8,29.31034483,41.37931034,29.31034483,14,50,0.75,Austria-Regionalliga-West-Salzburg,2022/05/06,2022/04/23 15:00
6,Salzburg 2,7,2,2,3,7,9,2,1,1,0,3,1,5,1,1,3,4,8,8,-2,2.29,1.285714286,0.5,1.6,1,1.5,0.8,29.31034483,41.37931034,29.31034483,14,50,0.75,Austria-Regionalliga-West-Salzburg,2022/05/06,2022/05/07 16:00
6,Salzburg 2,7,2,2,3,7,9,2,1,1,0,3,1,5,1,1,3,4,8,8,-2,2.29,1.285714286,0.5,1.6,1,1.5,0.8,29.31034483,41.37931034,29.31034483,14,50,0.75,Austria-Regionalliga-West-Salzburg,2022/05/06,2022/04/18 17:00
6,Salzburg 2,7,2,2,3,7,9,2,1,1,0,3,1,5,1,1,3,4,8,8,-2,2.29,1.285714286,0.5,1.6,1,1.5,0.8,29.31034483,41.37931034,29.31034483,14,50,0.75,Austria-Regionalliga-West-Salzburg,2022/05/06,2022/04/30 15:00
7,Bischofshofen,6,1,3,2,5,7,3,1,2,0,3,1,3,0,1,2,2,6,6,-2,2,1.166666667,0.333333333,2,0.833333333,1,0.666666667,29.31034483,41.37931034,29.31034483,14,42.9,0.875,Austria-Regionalliga-West-Salzburg,2022/05/06,2022/04/23 15:00
7,Bischofshofen,6,1,3,2,5,7,3,1,2,0,3,1,3,0,1,2,2,6,6,-2,2,1.166666667,0.333333333,2,0.833333333,1,0.666666667,29.31034483,41.37931034,29.31034483,14,42.9,0.875,Austria-Regionalliga-West-Salzburg,2022/05/06,2022/04/18 15:00
7,Bischofshofen,6,1,3,2,5,7,3,1,2,0,3,1,3,0,1,2,2,6,6,-2,2,1.166666667,0.333333333,2,0.833333333,1,0.666666667,29.31034483,41.37931034,29.31034483,14,42.9,0.875,Austria-Regionalliga-West-Salzburg,2022/05/06,2022/04/30 15:00
7,Bischofshofen,6,1,3,2,5,7,3,1,2,0,3,1,3,0,1,2,2,6,6,-2,2,1.166666667,0.333333333,2,0.833333333,1,0.666666667,29.31034483,41.37931034,29.31034483,14,42.9,0.875,Austria-Regionalliga-West-Salzburg,2022/05/06,2022/05/07 16:00
8,Wals Grunau,7,0,3,4,4,12,3,0,2,1,1,3,4,0,1,3,3,9,3,-8,2.29,1.714285714,1,2.25,0.571428571,0.333333333,0.75,29.31034483,41.37931034,29.31034483,14,50,1,Austria-Regionalliga-West-Salzburg,2022/05/06,2022/04/22 18:00
8,Wals Grunau,7,0,3,4,4,12,3,0,2,1,1,3,4,0,1,3,3,9,3,-8,2.29,1.714285714,1,2.25,0.571428571,0.333333333,0.75,29.31034483,41.37931034,29.31034483,14,50,1,Austria-Regionalliga-West-Salzburg,2022/05/06,2022/04/30 15:00
8,Wals Grunau,7,0,3,4,4,12,3,0,2,1,1,3,4,0,1,3,3,9,3,-8,2.29,1.714285714,1,2.25,0.571428571,0.333333333,0.75,29.31034483,41.37931034,29.31034483,14,50,1,Austria-Regionalliga-West-Salzburg,2022/05/06,2022/05/07 16:00
1,Fugen,2,1,1,0,4,3,1,1,0,0,2,1,1,0,1,0,2,2,4,1,3.5,1.5,1,2,2,2,2,41.66666667,16.66666667,41.66666667,8,25,0.2,Austria-Regionalliga-West-Tyrol,2022/05/06,2022/04/23 16:30
1,Fugen,2,1,1,0,4,3,1,1,0,0,2,1,1,0,1,0,2,2,4,1,3.5,1.5,1,2,2,2,2,41.66666667,16.66666667,41.66666667,8,25,0.2,Austria-Regionalliga-West-Tyrol,2022/05/06,2022/05/06 18:30
1,Fugen,2,1,1,0,4,3,1,1,0,0,2,1,1,0,1,0,2,2,4,1,3.5,1.5,1,2,2,2,2,41.66666667,16.66666667,41.66666667,8,25,0.2,Austria-Regionalliga-West-Tyrol,2022/05/06,2022/04/30 14:00
2,Wack Inns 2,3,1,1,1,6,7,2,1,1,0,5,3,1,0,0,1,1,4,4,-1,4.33,2.333333333,1.5,4,2,2.5,1,41.66666667,16.66666667,41.66666667,8,37.5,0.4,Austria-Regionalliga-West-Tyrol,2022/05/06,2022/04/23 13:00
2,Wack Inns 2,3,1,1,1,6,7,2,1,1,0,5,3,1,0,0,1,1,4,4,-1,4.33,2.333333333,1.5,4,2,2.5,1,41.66666667,16.66666667,41.66666667,8,37.5,0.4,Austria-Regionalliga-West-Tyrol,2022/05/06,2022/04/30 14:00
2,Wack Inns 2,3,1,1,1,6,7,2,1,1,0,5,3,1,0,0,1,1,4,4,-1,4.33,2.333333333,1.5,4,2,2.5,1,41.66666667,16.66666667,41.66666667,8,37.5,0.4,Austria-Regionalliga-West-Tyrol,2022/05/06,2022/04/08 18:00
2,Wack Inns 2,3,1,1,1,6,7,2,1,1,0,5,3,1,0,0,1,1,4,4,-1,4.33,2.333333333,1.5,4,2,2.5,1,41.66666667,16.66666667,41.66666667,8,37.5,0.4,Austria-Regionalliga-West-Tyrol,2022/05/06,2022/05/06 18:00
3,WSG Tirol Am,2,1,0,1,5,5,1,0,0,1,1,3,1,1,0,0,4,2,3,0,5,2.5,3,2,2.5,1,4,41.66666667,16.66666667,41.66666667,8,25,0.6,Austria-Regionalliga-West-Tyrol,2022/05/06,2022/04/10 10:00
3,WSG Tirol Am,2,1,0,1,5,5,1,0,0,1,1,3,1,1,0,0,4,2,3,0,5,2.5,3,2,2.5,1,4,41.66666667,16.66666667,41.66666667,8,25,0.6,Austria-Regionalliga-West-Tyrol,2022/05/06,2022/05/06 18:00
3,WSG Tirol Am,2,1,0,1,5,5,1,0,0,1,1,3,1,1,0,0,4,2,3,0,5,2.5,3,2,2.5,1,4,41.66666667,16.66666667,41.66666667,8,25,0.6,Austria-Regionalliga-West-Tyrol,2022/05/06,2022/04/30 16:00
4,Hall,2,1,0,1,4,4,0,0,0,0,0,0,2,1,0,1,4,4,3,0,4,2,,2,2,,2,41.66666667,16.66666667,41.66666667,8,25,0.8,Austria-Regionalliga-West-Tyrol,2022/05/06,2022/04/10 10:00
4,Hall,2,1,0,1,4,4,0,0,0,0,0,0,2,1,0,1,4,4,3,0,4,2,,2,2,,2,41.66666667,16.66666667,41.66666667,8,25,0.8,Austria-Regionalliga-West-Tyrol,2022/05/06,2022/04/23 13:00
4,Hall,2,1,0,1,4,4,0,0,0,0,0,0,2,1,0,1,4,4,3,0,4,2,,2,2,,2,41.66666667,16.66666667,41.66666667,8,25,0.8,Austria-Regionalliga-West-Tyrol,2022/05/06,2022/05/06 18:30
5,SV Innsbruck,3,1,0,2,7,7,2,1,0,1,6,5,1,0,0,1,1,2,3,0,4.67,2.333333333,2.5,2,2.333333333,3,1,41.66666667,16.66666667,41.66666667,8,37.5,1,Austria-Regionalliga-West-Tyrol,2022/05/06,2022/04/08 18:00
5,SV Innsbruck,3,1,0,2,7,7,2,1,0,1,6,5,1,0,0,1,1,2,3,0,4.67,2.333333333,2.5,2,2.333333333,3,1,41.66666667,16.66666667,41.66666667,8,37.5,1,Austria-Regionalliga-West-Tyrol,2022/05/06,2022/04/30 16:00
5,SV Innsbruck,3,1,0,2,7,7,2,1,0,1,6,5,1,0,0,1,1,2,3,0,4.67,2.333333333,2.5,2,2.333333333,3,1,41.66666667,16.66666667,41.66666667,8,37.5,1,Austria-Regionalliga-West-Tyrol,2022/05/06,2022/04/23 16:30
1,Genk,2,2,0,0,5,2,1,1,0,0,4,2,1,1,0,0,1,0,6,3,3.5,1,2,0,2.5,4,1,50,0,50,6,33.3,0.25,Belgium-Pro-League,2022/05/06,2022/04/29 19:45
1,Genk,2,2,0,0,5,2,1,1,0,0,4,2,1,1,0,0,1,0,6,3,3.5,1,2,0,2.5,4,1,50,0,50,6,33.3,0.25,Belgium-Pro-League,2022/05/06,2022/05/10 20:00
1,Genk,2,2,0,0,5,2,1,1,0,0,4,2,1,1,0,0,1,0,6,3,3.5,1,2,0,2.5,4,1,50,0,50,6,33.3,0.25,Belgium-Pro-League,2022/05/06,2022/04/24 15:00
1,Genk,2,2,0,0,5,2,1,1,0,0,4,2,1,1,0,0,1,0,6,3,3.5,1,2,0,2.5,4,1,50,0,50,6,33.3,0.25,Belgium-Pro-League,2022/05/06,2022/05/06 19:45
2,AA Gent,2,1,0,1,3,2,1,0,0,1,0,1,1,1,0,0,3,1,3,1,2.5,1,1,1,1.5,0,3,50,0,50,6,33.3,0.5,Belgium-Pro-League,2022/05/06,2022/04/24 15:00
2,AA Gent,2,1,0,1,3,2,1,0,0,1,0,1,1,1,0,0,3,1,3,1,2.5,1,1,1,1.5,0,3,50,0,50,6,33.3,0.5,Belgium-Pro-League,2022/05/06,2022/05/07 19:45
2,AA Gent,2,1,0,1,3,2,1,0,0,1,0,1,1,1,0,0,3,1,3,1,2.5,1,1,1,1.5,0,3,50,0,50,6,33.3,0.5,Belgium-Pro-League,2022/05/06,2022/04/30 17:30
2,AA Gent,2,1,0,1,3,2,1,0,0,1,0,1,1,1,0,0,3,1,3,1,2.5,1,1,1,1.5,0,3,50,0,50,6,33.3,0.5,Belgium-Pro-League,2022/05/06,2022/05/10 17:45
3,KV Mechelen,2,1,0,1,3,4,1,1,0,0,1,0,1,0,0,1,2,4,3,-1,3.5,2,0,4,1.5,1,2,50,0,50,6,33.3,0.75,Belgium-Pro-League,2022/05/06,2022/04/23 19:45
3,KV Mechelen,2,1,0,1,3,4,1,1,0,0,1,0,1,0,0,1,2,4,3,-1,3.5,2,0,4,1.5,1,2,50,0,50,6,33.3,0.75,Belgium-Pro-League,2022/05/06,2022/05/10 17:45
3,KV Mechelen,2,1,0,1,3,4,1,1,0,0,1,0,1,0,0,1,2,4,3,-1,3.5,2,0,4,1.5,1,2,50,0,50,6,33.3,0.75,Belgium-Pro-League,2022/05/06,2022/04/29 19:45
3,KV Mechelen,2,1,0,1,3,4,1,1,0,0,1,0,1,0,0,1,2,4,3,-1,3.5,2,0,4,1.5,1,2,50,0,50,6,33.3,0.75,Belgium-Pro-League,2022/05/06,2022/05/07 19:45
4,Charleroi,2,0,0,2,1,4,1,0,0,1,1,3,1,0,0,1,0,1,0,-3,2.5,2,3,1,0.5,1,0,50,0,50,6,33.3,1,Belgium-Pro-League,2022/05/06,2022/04/30 17:30
4,Charleroi,2,0,0,2,1,4,1,0,0,1,1,3,1,0,0,1,0,1,0,-3,2.5,2,3,1,0.5,1,0,50,0,50,6,33.3,1,Belgium-Pro-League,2022/05/06,2022/05/06 19:45
4,Charleroi,2,0,0,2,1,4,1,0,0,1,1,3,1,0,0,1,0,1,0,-3,2.5,2,3,1,0.5,1,0,50,0,50,6,33.3,1,Belgium-Pro-League,2022/05/06,2022/04/23 19:45
4,Charleroi,2,0,0,2,1,4,1,0,0,1,1,3,1,0,0,1,0,1,0,-3,2.5,2,3,1,0.5,1,0,50,0,50,6,33.3,1,Belgium-Pro-League,2022/05/06,2022/05/10 20:00
1,Zrinjski,28,23,4,1,66,11,15,14,1,0,46,7,13,9,3,1,20,4,73,55,2.75,0.392857143,0.466666667,0.307692308,2.357142857,3.066666667,1.538461538,33.33333333,33.33333333,33.33333333,22,127.3,0.083333333,Bosnia-Herzegovina-Premier,2022/05/06,2022/04/29 19:00
1,Zrinjski,28,23,4,1,66,11,15,14,1,0,46,7,13,9,3,1,20,4,73,55,2.75,0.392857143,0.466666667,0.307692308,2.357142857,3.066666667,1.538461538,33.33333333,33.33333333,33.33333333,22,127.3,0.083333333,Bosnia-Herzegovina-Premier,2022/05/06,2022/05/10 19:00
1,Zrinjski,28,23,4,1,66,11,15,14,1,0,46,7,13,9,3,1,20,4,73,55,2.75,0.392857143,0.466666667,0.307692308,2.357142857,3.066666667,1.538461538,33.33333333,33.33333333,33.33333333,22,127.3,0.083333333,Bosnia-Herzegovina-Premier,2022/05/06,2022/05/06 17:00
2,Tuzla City,28,13,11,4,43,32,15,7,7,1,26,16,13,6,4,3,17,16,50,11,2.68,1.142857143,1.066666667,1.230769231,1.535714286,1.733333333,1.307692308,33.33333333,33.33333333,33.33333333,22,127.3,0.166666667,Bosnia-Herzegovina-Premier,2022/05/06,2022/04/30 18:00
2,Tuzla City,28,13,11,4,43,32,15,7,7,1,26,16,13,6,4,3,17,16,50,11,2.68,1.142857143,1.066666667,1.230769231,1.535714286,1.733333333,1.307692308,33.33333333,33.33333333,33.33333333,22,127.3,0.166666667,Bosnia-Herzegovina-Premier,2022/05/06,2022/05/07 12:00
3,Borac Ban Lu,28,12,13,3,39,27,15,10,4,1,24,13,13,2,9,2,15,14,49,12,2.36,0.964285714,0.866666667,1.076923077,1.392857143,1.6,1.153846154,33.33333333,33.33333333,33.33333333,22,127.3,0.25,Bosnia-Herzegovina-Premier,2022/05/06,2022/04/30 16:00
3,Borac Ban Lu,28,12,13,3,39,27,15,10,4,1,24,13,13,2,9,2,15,14,49,12,2.36,0.964285714,0.866666667,1.076923077,1.392857143,1.6,1.153846154,33.33333333,33.33333333,33.33333333,22,127.3,0.25,Bosnia-Herzegovina-Premier,2022/05/06,2022/05/07 18:00
4,FK Sarajevo,28,11,6,11,34,26,14,6,3,5,21,11,14,5,3,6,13,15,39,8,2.14,0.928571429,0.785714286,1.071428571,1.214285714,1.5,0.928571429,33.33333333,33.33333333,33.33333333,22,127.3,0.333333333,Bosnia-Herzegovina-Premier,2022/05/06,2022/05/06 17:00
4,FK Sarajevo,28,11,6,11,34,26,14,6,3,5,21,11,14,5,3,6,13,15,39,8,2.14,0.928571429,0.785714286,1.071428571,1.214285714,1.5,0.928571429,33.33333333,33.33333333,33.33333333,22,127.3,0.333333333,Bosnia-Herzegovina-Premier,2022/05/06,2022/05/10 19:00
4,FK Sarajevo,28,11,6,11,34,26,14,6,3,5,21,11,14,5,3,6,13,15,39,8,2.14,0.928571429,0.785714286,1.071428571,1.214285714,1.5,0.928571429,33.33333333,33.33333333,33.33333333,22,127.3,0.333333333,Bosnia-Herzegovina-Premier,2022/05/06,2022/04/30 16:00
5,Zeljeznicar S,28,9,11,8,25,26,14,9,3,2,18,8,14,0,8,6,7,18,38,-1,1.82,0.928571429,0.571428571,1.285714286,0.892857143,1.285714286,0.5,33.33333333,33.33333333,33.33333333,22,127.3,0.416666667,Bosnia-Herzegovina-Premier,2022/05/06,2022/05/07 18:00
5,Zeljeznicar S,28,9,11,8,25,26,14,9,3,2,18,8,14,0,8,6,7,18,38,-1,1.82,0.928571429,0.571428571,1.285714286,0.892857143,1.285714286,0.5,33.33333333,33.33333333,33.33333333,22,127.3,0.416666667,Bosnia-Herzegovina-Premier,2022/05/06,2022/04/30 18:00
5,Zeljeznicar S,28,9,11,8,25,26,14,9,3,2,18,8,14,0,8,6,7,18,38,-1,1.82,0.928571429,0.571428571,1.285714286,0.892857143,1.285714286,0.5,33.33333333,33.33333333,33.33333333,22,127.3,0.416666667,Bosnia-Herzegovina-Premier,2022/05/06,2022/05/10 19:00
6,Velez Mosta,28,10,7,11,35,33,13,5,2,6,16,16,15,5,5,5,19,17,37,2,2.43,1.178571429,1.230769231,1.133333333,1.25,1.230769231,1.266666667,33.33333333,33.33333333,33.33333333,22,127.3,0.5,Bosnia-Herzegovina-Premier,2022/05/06,2022/04/25 17:00
6,Velez Mosta,28,10,7,11,35,33,13,5,2,6,16,16,15,5,5,5,19,17,37,2,2.43,1.178571429,1.230769231,1.133333333,1.25,1.230769231,1.266666667,33.33333333,33.33333333,33.33333333,22,127.3,0.5,Bosnia-Herzegovina-Premier,2022/05/06,2022/05/06 19:00
6,Velez Mosta,28,10,7,11,35,33,13,5,2,6,16,16,15,5,5,5,19,17,37,2,2.43,1.178571429,1.230769231,1.133333333,1.25,1.230769231,1.266666667,33.33333333,33.33333333,33.33333333,22,127.3,0.5,Bosnia-Herzegovina-Premier,2022/05/06,2022/05/01 15:30
6,Velez Mosta,28,10,7,11,35,33,13,5,2,6,16,16,15,5,5,5,19,17,37,2,2.43,1.178571429,1.230769231,1.133333333,1.25,1.230769231,1.266666667,33.33333333,33.33333333,33.33333333,22,127.3,0.5,Bosnia-Herzegovina-Premier,2022/05/06,2022/05/10 19:00
7,NK Siroki Brij,28,7,12,9,24,30,14,5,6,3,12,12,14,2,6,6,12,18,33,-6,1.93,1.071428571,0.857142857,1.285714286,0.857142857,0.857142857,0.857142857,33.33333333,33.33333333,33.33333333,22,127.3,0.583333333,Bosnia-Herzegovina-Premier,2022/05/06,2022/05/07 12:00
7,NK Siroki Brij,28,7,12,9,24,30,14,5,6,3,12,12,14,2,6,6,12,18,33,-6,1.93,1.071428571,0.857142857,1.285714286,0.857142857,0.857142857,0.857142857,33.33333333,33.33333333,33.33333333,22,127.3,0.583333333,Bosnia-Herzegovina-Premier,2022/05/06,2022/04/29 19:00
8,Sloboda Tuz,28,6,11,11,22,26,13,4,6,3,13,11,15,2,5,8,9,15,29,-4,1.71,0.928571429,0.846153846,1,0.785714286,1,0.6,33.33333333,33.33333333,33.33333333,22,127.3,0.666666667,Bosnia-Herzegovina-Premier,2022/05/06,2022/05/06 17:00
8,Sloboda Tuz,28,6,11,11,22,26,13,4,6,3,13,11,15,2,5,8,9,15,29,-4,1.71,0.928571429,0.846153846,1,0.785714286,1,0.6,33.33333333,33.33333333,33.33333333,22,127.3,0.666666667,Bosnia-Herzegovina-Premier,2022/05/06,2022/04/30 15:30
9,Leotar,28,7,6,15,20,42,14,4,5,5,13,18,14,3,1,10,7,24,27,-22,2.21,1.5,1.285714286,1.714285714,0.714285714,0.928571429,0.5,33.33333333,33.33333333,33.33333333,22,127.3,0.75,Bosnia-Herzegovina-Premier,2022/05/06,2022/05/01 15:30
9,Leotar,28,7,6,15,20,42,14,4,5,5,13,18,14,3,1,10,7,24,27,-22,2.21,1.5,1.285714286,1.714285714,0.714285714,0.928571429,0.5,33.33333333,33.33333333,33.33333333,22,127.3,0.75,Bosnia-Herzegovina-Premier,2022/05/06,2022/05/07 16:00
10,NK Posusje,28,5,11,12,24,48,13,5,6,2,14,12,15,0,5,10,10,36,26,-24,2.57,1.714285714,0.923076923,2.4,0.857142857,1.076923077,0.666666667,33.33333333,33.33333333,33.33333333,22,127.3,0.833333333,Bosnia-Herzegovina-Premier,2022/05/06,2022/05/07 16:00
10,NK Posusje,28,5,11,12,24,48,13,5,6,2,14,12,15,0,5,10,10,36,26,-24,2.57,1.714285714,0.923076923,2.4,0.857142857,1.076923077,0.666666667,33.33333333,33.33333333,33.33333333,22,127.3,0.833333333,Bosnia-Herzegovina-Premier,2022/05/06,2022/04/25 17:00
10,NK Posusje,28,5,11,12,24,48,13,5,6,2,14,12,15,0,5,10,10,36,26,-24,2.57,1.714285714,0.923076923,2.4,0.857142857,1.076923077,0.666666667,33.33333333,33.33333333,33.33333333,22,127.3,0.833333333,Bosnia-Herzegovina-Premier,2022/05/06,2022/04/30 14:00
11,Rudar Prijed,28,5,10,13,26,38,14,3,7,4,16,15,14,2,3,9,10,23,25,-12,2.29,1.357142857,1.071428571,1.642857143,0.928571429,1.142857143,0.714285714,33.33333333,33.33333333,33.33333333,22,127.3,0.916666667,Bosnia-Herzegovina-Premier,2022/05/06,2022/04/30 15:30
11,Rudar Prijed,28,5,10,13,26,38,14,3,7,4,16,15,14,2,3,9,10,23,25,-12,2.29,1.357142857,1.071428571,1.642857143,0.928571429,1.142857143,0.714285714,33.33333333,33.33333333,33.33333333,22,127.3,0.916666667,Bosnia-Herzegovina-Premier,2022/05/06,2022/05/06 19:00
12,Radnik Bij,28,4,10,14,24,43,14,3,6,5,11,13,14,1,4,9,13,30,22,-19,2.39,1.535714286,0.928571429,2.142857143,0.857142857,0.785714286,0.928571429,33.33333333,33.33333333,33.33333333,22,127.3,1,Bosnia-Herzegovina-Premier,2022/05/06,2022/04/30 14:00
12,Radnik Bij,28,4,10,14,24,43,14,3,6,5,11,13,14,1,4,9,13,30,22,-19,2.39,1.535714286,0.928571429,2.142857143,0.857142857,0.785714286,0.928571429,33.33333333,33.33333333,33.33333333,22,127.3,1,Bosnia-Herzegovina-Premier,2022/05/06,2022/05/06 17:00
1,Bahia,6,4,1,1,9,2,3,3,0,0,7,0,3,1,1,1,2,2,13,7,1.83,0.333333333,0,0.666666667,1.5,2.333333333,0.666666667,28.84615385,42.30769231,28.84615385,38,15.8,0.05,Brazil-Serie-B,2022/05/06,2022/05/03 23:00
2,Gremio,5,3,1,1,6,2,3,2,0,1,5,2,2,1,1,0,1,0,10,4,1.6,0.4,0.666666667,0,1.2,1.666666667,0.5,28.84615385,42.30769231,28.84615385,38,13.2,0.1,Brazil-Serie-B,2022/05/06,2022/05/08 20:00
3,Cruzeiro,5,3,1,1,5,3,2,2,0,0,2,0,3,1,1,1,3,3,10,2,1.6,0.6,0,1,1,1,1,28.84615385,42.30769231,28.84615385,38,13.2,0.15,Brazil-Serie-B,2022/05/06,2022/05/08 20:00
4,Chapecoense,6,2,3,1,5,3,3,0,2,1,1,3,3,2,1,0,4,0,9,2,1.33,0.5,1,0,0.833333333,0.333333333,1.333333333,28.84615385,42.30769231,28.84615385,38,15.8,0.2,Brazil-Serie-B,2022/05/06,2022/05/06 01:30
5,Ituano SP,5,2,2,1,5,3,3,2,1,0,4,1,2,0,1,1,1,2,8,2,1.6,0.6,0.333333333,1,1,1.333333333,0.5,28.84615385,42.30769231,28.84615385,38,13.2,0.25,Brazil-Serie-B,2022/05/06,2022/05/07 23:00
6,Sport Recife,5,2,2,1,3,2,2,2,0,0,2,0,3,0,2,1,1,2,8,1,1,0.4,0,0.666666667,0.6,1,0.333333333,28.84615385,42.30769231,28.84615385,38,13.2,0.3,Brazil-Serie-B,2022/05/06,2022/05/07 01:30
7,Vasco Gama,5,1,4,0,4,3,2,1,1,0,2,1,3,0,3,0,2,2,7,1,1.4,0.6,0.5,0.666666667,0.8,1,0.666666667,28.84615385,42.30769231,28.84615385,38,13.2,0.35,Brazil-Serie-B,2022/05/06,2022/05/07 23:00
7,Vasco Gama,5,1,4,0,4,3,2,1,1,0,2,1,3,0,3,0,2,2,7,1,1.4,0.6,0.5,0.666666667,0.8,1,0.666666667,28.84615385,42.30769231,28.84615385,38,13.2,0.35,Brazil-Serie-B,2022/05/06,2022/05/01 22:00
8,Nautico PE,5,2,1,2,5,5,3,1,1,1,3,2,2,1,0,1,2,3,7,0,2,1,0.666666667,1.5,1,1,1,28.84615385,42.30769231,28.84615385,38,13.2,0.4,Brazil-Serie-B,2022/05/06,2022/05/04 01:30
8,Nautico PE,5,2,1,2,5,5,3,1,1,1,3,2,2,1,0,1,2,3,7,0,2,1,0.666666667,1.5,1,1,1,28.84615385,42.30769231,28.84615385,38,13.2,0.4,Brazil-Serie-B,2022/05/06,2022/05/06 23:00
9,Ponte Preta,5,2,1,2,3,3,3,2,1,0,3,0,2,0,0,2,0,3,7,0,1.2,0.6,0,1.5,0.6,1,0,28.84615385,42.30769231,28.84615385,38,13.2,0.45,Brazil-Serie-B,2022/05/06,2022/05/08 20:00
10,Brusque,6,2,1,3,4,6,3,2,1,0,3,0,3,0,0,3,1,6,7,-2,1.67,1,0,2,0.666666667,1,0.333333333,28.84615385,42.30769231,28.84615385,38,15.8,0.5,Brazil-Serie-B,2022/05/06,2022/05/06 01:30
11,Criciuma,5,1,3,1,4,4,3,1,2,0,3,2,2,0,1,1,1,2,6,0,1.6,0.8,0.666666667,1,0.8,1,0.5,28.84615385,42.30769231,28.84615385,38,13.2,0.55,Brazil-Serie-B,2022/05/06,2022/05/01 15:00
11,Criciuma,5,1,3,1,4,4,3,1,2,0,3,2,2,0,1,1,1,2,6,0,1.6,0.8,0.666666667,1,0.8,1,0.5,28.84615385,42.30769231,28.84615385,38,13.2,0.55,Brazil-Serie-B,2022/05/06,2022/05/05 01:00
11,Criciuma,5,1,3,1,4,4,3,1,2,0,3,2,2,0,1,1,1,2,6,0,1.6,0.8,0.666666667,1,0.8,1,0.5,28.84615385,42.30769231,28.84615385,38,13.2,0.55,Brazil-Serie-B,2022/05/06,2022/05/07 20:30
12,CS Alagoano,5,1,3,1,3,4,3,1,2,0,3,2,2,0,1,1,0,2,6,-1,1.4,0.8,0.666666667,1,0.6,1,0,28.84615385,42.30769231,28.84615385,38,13.2,0.6,Brazil-Serie-B,2022/05/06,2022/05/05 01:00
12,CS Alagoano,5,1,3,1,3,4,3,1,2,0,3,2,2,0,1,1,0,2,6,-1,1.4,0.8,0.666666667,1,0.6,1,0,28.84615385,42.30769231,28.84615385,38,13.2,0.6,Brazil-Serie-B,2022/05/06,2022/05/07 23:00
13,Novorizontino,5,1,3,1,5,6,2,1,0,1,3,4,3,0,3,0,2,2,6,-1,2.2,1.2,2,0.666666667,1,1.5,0.666666667,28.84615385,42.30769231,28.84615385,38,13.2,0.65,Brazil-Serie-B,2022/05/06,2022/05/04 23:00
13,Novorizontino,5,1,3,1,5,6,2,1,0,1,3,4,3,0,3,0,2,2,6,-1,2.2,1.2,2,0.666666667,1,1.5,0.666666667,28.84615385,42.30769231,28.84615385,38,13.2,0.65,Brazil-Serie-B,2022/05/06,2022/05/07 23:00
13,Novorizontino,5,1,3,1,5,6,2,1,0,1,3,4,3,0,3,0,2,2,6,-1,2.2,1.2,2,0.666666667,1,1.5,0.666666667,28.84615385,42.30769231,28.84615385,38,13.2,0.65,Brazil-Serie-B,2022/05/06,2022/05/01 15:00
14,Samp Correa,5,1,2,2,5,5,3,1,2,0,5,3,2,0,0,2,0,2,5,0,2,1,1,1,1,1.666666667,0,28.84615385,42.30769231,28.84615385,38,13.2,0.7,Brazil-Serie-B,2022/05/06,2022/05/10 00:00
15,Tombense,5,0,5,0,5,5,3,0,3,0,3,3,2,0,2,0,2,2,5,0,2,1,1,1,1,1,1,28.84615385,42.30769231,28.84615385,38,13.2,0.75,Brazil-Serie-B,2022/05/06,2022/05/01 22:00
15,Tombense,5,0,5,0,5,5,3,0,3,0,3,3,2,0,2,0,2,2,5,0,2,1,1,1,1,1,1,28.84615385,42.30769231,28.84615385,38,13.2,0.75,Brazil-Serie-B,2022/05/06,2022/05/07 01:30
16,Operario PR,5,1,2,2,4,5,2,1,0,1,2,1,3,0,2,1,2,4,5,-1,1.8,1,0.5,1.333333333,0.8,1,0.666666667,28.84615385,42.30769231,28.84615385,38,13.2,0.8,Brazil-Serie-B,2022/05/06,2022/05/07 20:30
17,Guarani,5,1,2,2,3,5,2,1,1,0,1,0,3,0,1,2,2,5,5,-2,1.6,1,0,1.666666667,0.6,0.5,0.666666667,28.84615385,42.30769231,28.84615385,38,13.2,0.85,Brazil-Serie-B,2022/05/06,2022/05/08 20:00
17,Guarani,5,1,2,2,3,5,2,1,1,0,1,0,3,0,1,2,2,5,5,-2,1.6,1,0,1.666666667,0.6,0.5,0.666666667,28.84615385,42.30769231,28.84615385,38,13.2,0.85,Brazil-Serie-B,2022/05/06,2022/05/04 01:30
18,Londrina PR,6,1,2,3,5,9,3,1,2,0,5,3,3,0,0,3,0,6,5,-4,2.33,1.5,1,2,0.833333333,1.666666667,0,28.84615385,42.30769231,28.84615385,38,15.8,0.9,Brazil-Serie-B,2022/05/06,2022/05/03 23:00
19,Vil Nova GO,5,0,4,1,5,7,2,0,2,0,1,1,3,0,2,1,4,6,4,-2,2.4,1.4,0.5,2,1,0.5,1.333333333,28.84615385,42.30769231,28.84615385,38,13.2,0.95,Brazil-Serie-B,2022/05/06,2022/05/06 23:00
20,CRB AL,5,0,1,4,3,9,2,0,1,1,2,3,3,0,0,3,1,6,1,-6,2.4,1.8,1.5,2,0.6,1,0.333333333,28.84615385,42.30769231,28.84615385,38,13.2,1,Brazil-Serie-B,2022/05/06,2022/05/10 00:00
20,CRB AL,5,0,1,4,3,9,2,0,1,1,2,3,3,0,0,3,1,6,1,-6,2.4,1.8,1.5,2,0.6,1,0.333333333,28.84615385,42.30769231,28.84615385,38,13.2,1,Brazil-Serie-B,2022/05/06,2022/05/04 23:00
1,Ludogorets,2,2,0,0,9,1,2,2,0,0,9,1,0,0,0,0,0,0,6,8,5,0.5,0.5,,4.5,4.5,,33.33333333,33.33333333,33.33333333,10,20,0.166666667,Bulgaria-Parva-Liga,2022/05/06,2022/04/30 18:00
1,Ludogorets,2,2,0,0,9,1,2,2,0,0,9,1,0,0,0,0,0,0,6,8,5,0.5,0.5,,4.5,4.5,,33.33333333,33.33333333,33.33333333,10,20,0.166666667,Bulgaria-Parva-Liga,2022/05/06,2022/05/06 13:00
2,Levski Sofia,2,1,1,0,2,0,1,1,0,0,2,0,1,0,1,0,0,0,4,2,1,0,0,0,1,2,0,33.33333333,33.33333333,33.33333333,10,20,0.333333333,Bulgaria-Parva-Liga,2022/05/06,2022/04/30 15:30
2,Levski Sofia,2,1,1,0,2,0,1,1,0,0,2,0,1,0,1,0,0,0,4,2,1,0,0,0,1,2,0,33.33333333,33.33333333,33.33333333,10,20,0.333333333,Bulgaria-Parva-Liga,2022/05/06,2022/05/06 15:30
3,Botev Plov,2,1,0,1,1,2,1,1,0,0,1,0,1,0,0,1,0,2,3,-1,1.5,1,0,2,0.5,1,0,33.33333333,33.33333333,33.33333333,10,20,0.5,Bulgaria-Parva-Liga,2022/05/06,2022/05/06 13:00
3,Botev Plov,2,1,0,1,1,2,1,1,0,0,1,0,1,0,0,1,0,2,3,-1,1.5,1,0,2,0.5,1,0,33.33333333,33.33333333,33.33333333,10,20,0.5,Bulgaria-Parva-Liga,2022/05/06,2022/04/30 15:30
4,Cherno More,2,0,1,1,1,2,0,0,0,0,0,0,2,0,1,1,1,2,1,-1,1.5,1,,1,0.5,,0.5,33.33333333,33.33333333,33.33333333,10,20,0.666666667,Bulgaria-Parva-Liga,2022/05/06,2022/05/06 15:30
4,Cherno More,2,0,1,1,1,2,0,0,0,0,0,0,2,0,1,1,1,2,1,-1,1.5,1,,1,0.5,,0.5,33.33333333,33.33333333,33.33333333,10,20,0.666666667,Bulgaria-Parva-Liga,2022/05/06,2022/05/01 17:00
5,Slavia Sof,2,0,1,1,2,5,1,0,1,0,1,1,1,0,0,1,1,4,1,-3,3.5,2.5,1,4,1,1,1,33.33333333,33.33333333,33.33333333,10,20,0.833333333,Bulgaria-Parva-Liga,2022/05/06,2022/05/01 17:00
5,Slavia Sof,2,0,1,1,2,5,1,0,1,0,1,1,1,0,0,1,1,4,1,-3,3.5,2.5,1,4,1,1,1,33.33333333,33.33333333,33.33333333,10,20,0.833333333,Bulgaria-Parva-Liga,2022/05/06,2022/05/06 18:00
6,CSKA Sofia,2,0,1,1,0,5,1,0,1,0,0,0,1,0,0,1,0,5,1,-5,2.5,2.5,0,5,0,0,0,33.33333333,33.33333333,33.33333333,10,20,1,Bulgaria-Parva-Liga,2022/05/06,2022/05/06 18:00
6,CSKA Sofia,2,0,1,1,0,5,1,0,1,0,0,0,1,0,0,1,0,5,1,-5,2.5,2.5,0,5,0,0,0,33.33333333,33.33333333,33.33333333,10,20,1,Bulgaria-Parva-Liga,2022/05/06,2022/04/30 18:00
1,Magallanes,11,10,1,0,25,8,5,5,0,0,11,2,6,5,1,0,14,6,31,17,3,0.727272727,0.4,1,2.272727273,2.2,2.333333333,30.68181818,38.63636364,30.68181818,32,34.4,0.058823529,Chile-Primera-B,2022/05/06,2022/05/08 20:00
2,Rangers Tal,12,7,1,4,20,15,6,3,0,3,11,11,6,4,1,1,9,4,22,5,2.92,1.25,1.833333333,0.666666667,1.666666667,1.833333333,1.5,30.68181818,38.63636364,30.68181818,32,37.5,0.117647059,Chile-Primera-B,2022/05/06,2022/04/30 22:00
2,Rangers Tal,12,7,1,4,20,15,6,3,0,3,11,11,6,4,1,1,9,4,22,5,2.92,1.25,1.833333333,0.666666667,1.666666667,1.833333333,1.5,30.68181818,38.63636364,30.68181818,32,37.5,0.117647059,Chile-Primera-B,2022/05/06,2022/05/07 17:30
3,Cobreloa,10,6,2,2,16,10,4,4,0,0,10,4,6,2,2,2,6,6,20,6,2.6,1,1,1,1.6,2.5,1,30.68181818,38.63636364,30.68181818,32,31.2,0.176470588,Chile-Primera-B,2022/05/06,
4,San Felipe,8,5,3,0,10,3,5,3,2,0,5,1,3,2,1,0,5,2,18,7,1.62,0.375,0.2,0.666666667,1.25,1,1.666666667,30.68181818,38.63636364,30.68181818,32,25,0.235294118,Chile-Primera-B,2022/05/06,2022/05/08 20:00
5,Santiago Morni,10,4,4,2,16,14,5,2,2,1,7,6,5,2,2,1,9,8,16,2,3,1.4,1.2,1.6,1.6,1.4,1.8,30.68181818,38.63636364,30.68181818,32,31.2,0.294117647,Chile-Primera-B,2022/05/06,2022/05/07 17:30
5,Santiago Morni,10,4,4,2,16,14,5,2,2,1,7,6,5,2,2,1,9,8,16,2,3,1.4,1.2,1.6,1.6,1.4,1.8,30.68181818,38.63636364,30.68181818,32,31.2,0.294117647,Chile-Primera-B,2022/05/06,2022/04/30 22:00
6,Melipilla,11,4,3,4,11,11,6,3,2,1,7,5,5,1,1,3,4,6,15,0,2,1,0.833333333,1.2,1,1.166666667,0.8,30.68181818,38.63636364,30.68181818,32,34.4,0.352941176,Chile-Primera-B,2022/05/06,2022/04/29 23:00
6,Melipilla,11,4,3,4,11,11,6,3,2,1,7,5,5,1,1,3,4,6,15,0,2,1,0.833333333,1.2,1,1.166666667,0.8,30.68181818,38.63636364,30.68181818,32,34.4,0.352941176,Chile-Primera-B,2022/05/06,2022/05/08 20:00
7,Puerto Montt,11,3,5,3,13,11,5,3,2,0,8,1,6,0,3,3,5,10,14,2,2.18,1,0.2,1.666666667,1.181818182,1.6,0.833333333,30.68181818,38.63636364,30.68181818,32,34.4,0.411764706,Chile-Primera-B,2022/05/06,2022/04/30 19:30
7,Puerto Montt,11,3,5,3,13,11,5,3,2,0,8,1,6,0,3,3,5,10,14,2,2.18,1,0.2,1.666666667,1.181818182,1.6,0.833333333,30.68181818,38.63636364,30.68181818,32,34.4,0.411764706,Chile-Primera-B,2022/05/06,2022/05/07 17:30
8,Copiapo,9,3,4,2,13,10,5,3,2,0,9,3,4,0,2,2,4,7,13,3,2.56,1.111111111,0.6,1.75,1.444444444,1.8,1,30.68181818,38.63636364,30.68181818,32,28.1,0.470588235,Chile-Primera-B,2022/05/06,2022/04/30 19:30
8,Copiapo,9,3,4,2,13,10,5,3,2,0,9,3,4,0,2,2,4,7,13,3,2.56,1.111111111,0.6,1.75,1.444444444,1.8,1,30.68181818,38.63636364,30.68181818,32,28.1,0.470588235,Chile-Primera-B,2022/05/06,2022/05/07 17:30
9,Dep Iquique,10,2,5,3,8,9,5,2,2,1,6,5,5,0,3,2,2,4,11,-1,1.7,0.9,1,0.8,0.8,1.2,0.4,30.68181818,38.63636364,30.68181818,32,31.2,0.529411765,Chile-Primera-B,2022/05/06,2022/05/07 01:30
9,Dep Iquique,10,2,5,3,8,9,5,2,2,1,6,5,5,0,3,2,2,4,11,-1,1.7,0.9,1,0.8,0.8,1.2,0.4,30.68181818,38.63636364,30.68181818,32,31.2,0.529411765,Chile-Primera-B,2022/05/06,2022/04/30 01:30
10,Temuco,11,2,5,4,11,16,5,2,2,1,7,7,6,0,3,3,4,9,11,-5,2.45,1.454545455,1.4,1.5,1,1.4,0.666666667,30.68181818,38.63636364,30.68181818,32,34.4,0.588235294,Chile-Primera-B,2022/05/06,2022/05/06 23:00
10,Temuco,11,2,5,4,11,16,5,2,2,1,7,7,6,0,3,3,4,9,11,-5,2.45,1.454545455,1.4,1.5,1,1.4,0.666666667,30.68181818,38.63636364,30.68181818,32,34.4,0.588235294,Chile-Primera-B,2022/05/06,2022/04/30 01:30
11,Wanderers,10,2,4,4,9,13,4,1,1,2,5,7,6,1,3,2,4,6,10,-4,2.2,1.3,1.75,1,0.9,1.25,0.666666667,30.68181818,38.63636364,30.68181818,32,31.2,0.647058824,Chile-Primera-B,2022/05/06,2022/05/06 23:00
11,Wanderers,10,2,4,4,9,13,4,1,1,2,5,7,6,1,3,2,4,6,10,-4,2.2,1.3,1.75,1,0.9,1.25,0.666666667,30.68181818,38.63636364,30.68181818,32,31.2,0.647058824,Chile-Primera-B,2022/05/06,2022/05/01 00:30
12,A Fernandz V,11,1,7,3,8,13,5,1,3,1,3,3,6,0,4,2,5,10,10,-5,1.91,1.181818182,0.6,1.666666667,0.727272727,0.6,0.833333333,30.68181818,38.63636364,30.68181818,32,34.4,0.705882353,Chile-Primera-B,2022/05/06,2022/05/08 20:00
12,A Fernandz V,11,1,7,3,8,13,5,1,3,1,3,3,6,0,4,2,5,10,10,-5,1.91,1.181818182,0.6,1.666666667,0.727272727,0.6,0.833333333,30.68181818,38.63636364,30.68181818,32,34.4,0.705882353,Chile-Primera-B,2022/05/06,2022/04/30 19:30
13,S Luis Quill,11,2,4,5,11,17,6,1,3,2,5,7,5,1,1,3,6,10,10,-6,2.55,1.545454545,1.166666667,2,1,0.833333333,1.2,30.68181818,38.63636364,30.68181818,32,34.4,0.764705882,Chile-Primera-B,2022/05/06,2022/04/30 01:30
13,S Luis Quill,11,2,4,5,11,17,6,1,3,2,5,7,5,1,1,3,6,10,10,-6,2.55,1.545454545,1.166666667,2,1,0.833333333,1.2,30.68181818,38.63636364,30.68181818,32,34.4,0.764705882,Chile-Primera-B,2022/05/06,2022/05/07 01:30
14,U Concepcion,11,1,6,4,10,14,6,0,4,2,6,10,5,1,2,2,4,4,9,-4,2.18,1.272727273,1.666666667,0.8,0.909090909,1,0.8,30.68181818,38.63636364,30.68181818,32,34.4,0.823529412,Chile-Primera-B,2022/05/06,2022/04/30 01:30
14,U Concepcion,11,1,6,4,10,14,6,0,4,2,6,10,5,1,2,2,4,4,9,-4,2.18,1.272727273,1.666666667,0.8,0.909090909,1,0.8,30.68181818,38.63636364,30.68181818,32,34.4,0.823529412,Chile-Primera-B,2022/05/06,2022/05/06 23:00
15,Barnechea,10,1,5,4,11,16,5,1,3,1,6,5,5,0,2,3,5,11,8,-5,2.7,1.6,1,2.2,1.1,1.2,1,30.68181818,38.63636364,30.68181818,32,31.2,0.882352941,Chile-Primera-B,2022/05/06,2022/04/29 23:00
15,Barnechea,10,1,5,4,11,16,5,1,3,1,6,5,5,0,2,3,5,11,8,-5,2.7,1.6,1,2.2,1.1,1.2,1,30.68181818,38.63636364,30.68181818,32,31.2,0.882352941,Chile-Primera-B,2022/05/06,2022/05/06 23:00
16,Recoleta,10,1,4,5,8,13,6,1,2,3,7,8,4,0,2,2,1,5,7,-5,2.1,1.3,1.333333333,1.25,0.8,1.166666667,0.25,30.68181818,38.63636364,30.68181818,32,31.2,0.941176471,Chile-Primera-B,2022/05/06,2022/05/01 00:30
16,Recoleta,10,1,4,5,8,13,6,1,2,3,7,8,4,0,2,2,1,5,7,-5,2.1,1.3,1.333333333,1.25,0.8,1.166666667,0.25,30.68181818,38.63636364,30.68181818,32,31.2,0.941176471,Chile-Primera-B,2022/05/06,2022/05/08 01:00
17,Dp San Cruz,10,0,5,5,9,16,5,0,4,1,5,6,5,0,1,4,4,10,5,-7,2.5,1.6,1.2,2,0.9,1,0.8,30.68181818,38.63636364,30.68181818,32,31.2,1,Chile-Primera-B,2022/05/06,2022/05/08 01:00
17,Dp San Cruz,10,0,5,5,9,16,5,0,4,1,5,6,5,0,1,4,4,10,5,-7,2.5,1.6,1.2,2,0.9,1,0.8,30.68181818,38.63636364,30.68181818,32,31.2,1,Chile-Primera-B,2022/05/06,2022/04/30 19:30
1,Dinamo Zag,33,21,7,5,60,21,16,10,4,2,32,10,17,11,3,3,28,11,70,39,2.45,0.636363636,0.625,0.647058824,1.818181818,2,1.647058824,38.18181818,23.63636364,38.18181818,18,183.3,0.1,Croatia-1-HNL,2022/05/06,2022/05/08 19:00
1,Dinamo Zag,33,21,7,5,60,21,16,10,4,2,32,10,17,11,3,3,28,11,70,39,2.45,0.636363636,0.625,0.647058824,1.818181818,2,1.647058824,38.18181818,23.63636364,38.18181818,18,183.3,0.1,Croatia-1-HNL,2022/05/06,2022/04/24 18:05
1,Dinamo Zag,33,21,7,5,60,21,16,10,4,2,32,10,17,11,3,3,28,11,70,39,2.45,0.636363636,0.625,0.647058824,1.818181818,2,1.647058824,38.18181818,23.63636364,38.18181818,18,183.3,0.1,Croatia-1-HNL,2022/05/06,2022/05/01 18:05
2,Hajduk,33,19,9,5,57,27,17,11,3,3,26,10,16,8,6,2,31,17,66,30,2.55,0.818181818,0.588235294,1.0625,1.727272727,1.529411765,1.9375,38.18181818,23.63636364,38.18181818,18,183.3,0.2,Croatia-1-HNL,2022/05/06,2022/04/29 17:00
2,Hajduk,33,19,9,5,57,27,17,11,3,3,26,10,16,8,6,2,31,17,66,30,2.55,0.818181818,0.588235294,1.0625,1.727272727,1.529411765,1.9375,38.18181818,23.63636364,38.18181818,18,183.3,0.2,Croatia-1-HNL,2022/05/06,2022/04/24 16:00
2,Hajduk,33,19,9,5,57,27,17,11,3,3,26,10,16,8,6,2,31,17,66,30,2.55,0.818181818,0.588235294,1.0625,1.727272727,1.529411765,1.9375,38.18181818,23.63636364,38.18181818,18,183.3,0.2,Croatia-1-HNL,2022/05/06,2022/05/08 16:00
3,Osijek,33,18,11,4,47,25,17,10,5,2,25,12,16,8,6,2,22,13,65,22,2.18,0.757575758,0.705882353,0.8125,1.424242424,1.470588235,1.375,38.18181818,23.63636364,38.18181818,18,183.3,0.3,Croatia-1-HNL,2022/05/06,2022/05/01 16:00
3,Osijek,33,18,11,4,47,25,17,10,5,2,25,12,16,8,6,2,22,13,65,22,2.18,0.757575758,0.705882353,0.8125,1.424242424,1.470588235,1.375,38.18181818,23.63636364,38.18181818,18,183.3,0.3,Croatia-1-HNL,2022/05/06,2022/04/23 19:00
3,Osijek,33,18,11,4,47,25,17,10,5,2,25,12,16,8,6,2,22,13,65,22,2.18,0.757575758,0.705882353,0.8125,1.424242424,1.470588235,1.375,38.18181818,23.63636364,38.18181818,18,183.3,0.3,Croatia-1-HNL,2022/05/06,2022/05/08 19:00
4,Rijeka,33,19,4,10,68,46,16,10,2,4,34,20,17,9,2,6,34,26,61,22,3.45,1.393939394,1.25,1.529411765,2.060606061,2.125,2,38.18181818,23.63636364,38.18181818,18,183.3,0.4,Croatia-1-HNL,2022/05/06,2022/04/23 19:00
4,Rijeka,33,19,4,10,68,46,16,10,2,4,34,20,17,9,2,6,34,26,61,22,3.45,1.393939394,1.25,1.529411765,2.060606061,2.125,2,38.18181818,23.63636364,38.18181818,18,183.3,0.4,Croatia-1-HNL,2022/05/06,2022/05/08 16:00
4,Rijeka,33,19,4,10,68,46,16,10,2,4,34,20,17,9,2,6,34,26,61,22,3.45,1.393939394,1.25,1.529411765,2.060606061,2.125,2,38.18181818,23.63636364,38.18181818,18,183.3,0.4,Croatia-1-HNL,2022/05/06,2022/04/30 18:05
5,Loko Zagreb,33,11,12,10,50,45,17,8,7,2,29,17,16,3,5,8,21,28,45,5,2.88,1.363636364,1,1.75,1.515151515,1.705882353,1.3125,38.18181818,23.63636364,38.18181818,18,183.3,0.5,Croatia-1-HNL,2022/05/06,2022/05/01 18:05
5,Loko Zagreb,33,11,12,10,50,45,17,8,7,2,29,17,16,3,5,8,21,28,45,5,2.88,1.363636364,1,1.75,1.515151515,1.705882353,1.3125,38.18181818,23.63636364,38.18181818,18,183.3,0.5,Croatia-1-HNL,2022/05/06,2022/04/23 16:00
5,Loko Zagreb,33,11,12,10,50,45,17,8,7,2,29,17,16,3,5,8,21,28,45,5,2.88,1.363636364,1,1.75,1.515151515,1.705882353,1.3125,38.18181818,23.63636364,38.18181818,18,183.3,0.5,Croatia-1-HNL,2022/05/06,2022/05/07 16:00
6,Gorica,33,11,7,15,37,46,16,4,5,7,21,27,17,7,2,8,16,19,40,-9,2.52,1.393939394,1.6875,1.117647059,1.121212121,1.3125,0.941176471,38.18181818,23.63636364,38.18181818,18,183.3,0.6,Croatia-1-HNL,2022/05/06,2022/04/24 18:05
6,Gorica,33,11,7,15,37,46,16,4,5,7,21,27,17,7,2,8,16,19,40,-9,2.52,1.393939394,1.6875,1.117647059,1.121212121,1.3125,0.941176471,38.18181818,23.63636364,38.18181818,18,183.3,0.6,Croatia-1-HNL,2022/05/06,2022/05/07 16:00
6,Gorica,33,11,7,15,37,46,16,4,5,7,21,27,17,7,2,8,16,19,40,-9,2.52,1.393939394,1.6875,1.117647059,1.121212121,1.3125,0.941176471,38.18181818,23.63636364,38.18181818,18,183.3,0.6,Croatia-1-HNL,2022/05/06,2022/04/30 16:00
7,Slaven,33,9,7,17,31,48,17,4,5,8,15,22,16,5,2,9,16,26,34,-17,2.39,1.454545455,1.294117647,1.625,0.939393939,0.882352941,1,38.18181818,23.63636364,38.18181818,18,183.3,0.7,Croatia-1-HNL,2022/05/06,2022/04/24 16:00
7,Slaven,33,9,7,17,31,48,17,4,5,8,15,22,16,5,2,9,16,26,34,-17,2.39,1.454545455,1.294117647,1.625,0.939393939,0.882352941,1,38.18181818,23.63636364,38.18181818,18,183.3,0.7,Croatia-1-HNL,2022/05/06,2022/04/30 16:00
7,Slaven,33,9,7,17,31,48,17,4,5,8,15,22,16,5,2,9,16,26,34,-17,2.39,1.454545455,1.294117647,1.625,0.939393939,0.882352941,1,38.18181818,23.63636364,38.18181818,18,183.3,0.7,Croatia-1-HNL,2022/05/06,2022/05/06 17:00
8,Sibenik,33,8,5,20,43,70,17,6,1,10,25,35,16,2,4,10,18,35,29,-27,3.42,2.121212121,2.058823529,2.1875,1.303030303,1.470588235,1.125,38.18181818,23.63636364,38.18181818,18,183.3,0.8,Croatia-1-HNL,2022/05/06,2022/04/30 18:05
8,Sibenik,33,8,5,20,43,70,17,6,1,10,25,35,16,2,4,10,18,35,29,-27,3.42,2.121212121,2.058823529,2.1875,1.303030303,1.470588235,1.125,38.18181818,23.63636364,38.18181818,18,183.3,0.8,Croatia-1-HNL,2022/05/06,2022/04/22 17:00
8,Sibenik,33,8,5,20,43,70,17,6,1,10,25,35,16,2,4,10,18,35,29,-27,3.42,2.121212121,2.058823529,2.1875,1.303030303,1.470588235,1.125,38.18181818,23.63636364,38.18181818,18,183.3,0.8,Croatia-1-HNL,2022/05/06,2022/05/07 18:05
9,Istra 1961,33,6,10,17,37,61,16,5,2,9,27,32,17,1,8,8,10,29,28,-24,2.97,1.848484848,2,1.705882353,1.121212121,1.6875,0.588235294,38.18181818,23.63636364,38.18181818,18,183.3,0.9,Croatia-1-HNL,2022/05/06,2022/04/23 16:00
9,Istra 1961,33,6,10,17,37,61,16,5,2,9,27,32,17,1,8,8,10,29,28,-24,2.97,1.848484848,2,1.705882353,1.121212121,1.6875,0.588235294,38.18181818,23.63636364,38.18181818,18,183.3,0.9,Croatia-1-HNL,2022/05/06,2022/05/07 18:05
9,Istra 1961,33,6,10,17,37,61,16,5,2,9,27,32,17,1,8,8,10,29,28,-24,2.97,1.848484848,2,1.705882353,1.121212121,1.6875,0.588235294,38.18181818,23.63636364,38.18181818,18,183.3,0.9,Croatia-1-HNL,2022/05/06,2022/05/01 16:00
10,Hrv Dragovo,33,4,6,23,30,71,16,2,5,9,14,27,17,2,1,14,16,44,18,-41,3.06,2.151515152,1.6875,2.588235294,0.909090909,0.875,0.941176471,38.18181818,23.63636364,38.18181818,18,183.3,1,Croatia-1-HNL,2022/05/06,2022/04/22 17:00
10,Hrv Dragovo,33,4,6,23,30,71,16,2,5,9,14,27,17,2,1,14,16,44,18,-41,3.06,2.151515152,1.6875,2.588235294,0.909090909,0.875,0.941176471,38.18181818,23.63636364,38.18181818,18,183.3,1,Croatia-1-HNL,2022/05/06,2022/05/06 17:00
10,Hrv Dragovo,33,4,6,23,30,71,16,2,5,9,14,27,17,2,1,14,16,44,18,-41,3.06,2.151515152,1.6875,2.588235294,0.909090909,0.875,0.941176471,38.18181818,23.63636364,38.18181818,18,183.3,1,Croatia-1-HNL,2022/05/06,2022/04/29 17:00
1,NK Varazdin,26,15,6,5,44,24,13,10,2,1,30,11,13,5,4,4,14,13,51,20,2.62,0.923076923,0.846153846,1,1.692307692,2.307692308,1.076923077,37.74038462,24.51923077,37.74038462,30,86.7,0.0625,Croatia-2-HNL,2022/05/06,2022/05/07 18:00
2,Rudes,26,15,4,7,49,23,13,12,1,0,37,6,13,3,3,7,12,17,49,26,2.77,0.884615385,0.461538462,1.307692308,1.884615385,2.846153846,0.923076923,37.74038462,24.51923077,37.74038462,30,86.7,0.125,Croatia-2-HNL,2022/05/06,2022/05/07 16:00
3,Inter Zap,26,11,8,7,27,25,13,7,3,3,14,9,13,4,5,4,13,16,41,2,2,0.961538462,0.692307692,1.230769231,1.038461538,1.076923077,1,37.74038462,24.51923077,37.74038462,30,86.7,0.1875,Croatia-2-HNL,2022/05/06,2022/05/02 16:00
3,Inter Zap,26,11,8,7,27,25,13,7,3,3,14,9,13,4,5,4,13,16,41,2,2,0.961538462,0.692307692,1.230769231,1.038461538,1.076923077,1,37.74038462,24.51923077,37.74038462,30,86.7,0.1875,Croatia-2-HNL,2022/05/06,2022/05/07 16:00
4,NK Jarun,26,10,10,6,40,30,13,6,5,2,26,17,13,4,5,4,14,13,40,10,2.69,1.153846154,1.307692308,1,1.538461538,2,1.076923077,37.74038462,24.51923077,37.74038462,30,86.7,0.25,Croatia-2-HNL,2022/05/06,2022/04/30 16:00
4,NK Jarun,26,10,10,6,40,30,13,6,5,2,26,17,13,4,5,4,14,13,40,10,2.69,1.153846154,1.307692308,1,1.538461538,2,1.076923077,37.74038462,24.51923077,37.74038462,30,86.7,0.25,Croatia-2-HNL,2022/05/06,2022/05/07 18:00
5,Din Zagreb 2,26,10,8,8,30,33,13,10,3,0,19,6,13,0,5,8,11,27,38,-3,2.42,1.269230769,0.461538462,2.076923077,1.153846154,1.461538462,0.846153846,37.74038462,24.51923077,37.74038462,30,86.7,0.3125,Croatia-2-HNL,2022/05/06,2022/05/02 16:00
5,Din Zagreb 2,26,10,8,8,30,33,13,10,3,0,19,6,13,0,5,8,11,27,38,-3,2.42,1.269230769,0.461538462,2.076923077,1.153846154,1.461538462,0.846153846,37.74038462,24.51923077,37.74038462,30,86.7,0.3125,Croatia-2-HNL,2022/05/06,2022/05/08 14:00
6,Bijelo Brdo,26,11,4,11,24,32,13,8,2,3,18,14,13,3,2,8,6,18,37,-8,2.15,1.230769231,1.076923077,1.384615385,0.923076923,1.384615385,0.461538462,37.74038462,24.51923077,37.74038462,30,86.7,0.375,Croatia-2-HNL,2022/05/06,2022/05/08 16:00
6,Bijelo Brdo,26,11,4,11,24,32,13,8,2,3,18,14,13,3,2,8,6,18,37,-8,2.15,1.230769231,1.076923077,1.384615385,0.923076923,1.384615385,0.461538462,37.74038462,24.51923077,37.74038462,30,86.7,0.375,Croatia-2-HNL,2022/05/06,2022/04/30 16:00
7,Dubrava,26,10,6,10,33,31,13,8,3,2,24,11,13,2,3,8,9,20,36,2,2.46,1.192307692,0.846153846,1.538461538,1.269230769,1.846153846,0.692307692,37.74038462,24.51923077,37.74038462,30,86.7,0.4375,Croatia-2-HNL,2022/05/06,2022/05/02 16:00
7,Dubrava,26,10,6,10,33,31,13,8,3,2,24,11,13,2,3,8,9,20,36,2,2.46,1.192307692,0.846153846,1.538461538,1.269230769,1.846153846,0.692307692,37.74038462,24.51923077,37.74038462,30,86.7,0.4375,Croatia-2-HNL,2022/05/06,2022/05/07 16:00
8,Dugopolje,26,9,7,10,33,37,13,7,4,2,18,12,13,2,3,8,15,25,34,-4,2.69,1.423076923,0.923076923,1.923076923,1.269230769,1.384615385,1.153846154,37.74038462,24.51923077,37.74038462,30,86.7,0.5,Croatia-2-HNL,2022/05/06,2022/04/30 16:00
8,Dugopolje,26,9,7,10,33,37,13,7,4,2,18,12,13,2,3,8,15,25,34,-4,2.69,1.423076923,0.923076923,1.923076923,1.269230769,1.384615385,1.153846154,37.74038462,24.51923077,37.74038462,30,86.7,0.5,Croatia-2-HNL,2022/05/06,2022/05/08 16:00
9,Orijent,26,10,4,12,34,41,13,6,2,5,20,20,13,4,2,7,14,21,34,-7,2.88,1.576923077,1.538461538,1.615384615,1.307692308,1.538461538,1.076923077,37.74038462,24.51923077,37.74038462,30,86.7,0.5625,Croatia-2-HNL,2022/05/06,2022/04/30 16:00
9,Orijent,26,10,4,12,34,41,13,6,2,5,20,20,13,4,2,7,14,21,34,-7,2.88,1.576923077,1.538461538,1.615384615,1.307692308,1.538461538,1.076923077,37.74038462,24.51923077,37.74038462,30,86.7,0.5625,Croatia-2-HNL,2022/05/06,2022/05/08 14:00
10,Osijek 2,26,9,6,11,24,30,13,5,3,5,13,15,13,4,3,6,11,15,33,-6,2.08,1.153846154,1.153846154,1.153846154,0.923076923,1,0.846153846,37.74038462,24.51923077,37.74038462,30,86.7,0.625,Croatia-2-HNL,2022/05/06,2022/05/02 16:00
10,Osijek 2,26,9,6,11,24,30,13,5,3,5,13,15,13,4,3,6,11,15,33,-6,2.08,1.153846154,1.153846154,1.153846154,0.923076923,1,0.846153846,37.74038462,24.51923077,37.74038462,30,86.7,0.625,Croatia-2-HNL,2022/05/06,2022/05/07 16:00
11,Kustosija,26,8,8,10,31,30,13,5,5,3,15,12,13,3,3,7,16,18,32,1,2.35,1.153846154,0.923076923,1.384615385,1.192307692,1.153846154,1.230769231,37.74038462,24.51923077,37.74038462,30,86.7,0.6875,Croatia-2-HNL,2022/05/06,2022/05/07 16:00
11,Kustosija,26,8,8,10,31,30,13,5,5,3,15,12,13,3,3,7,16,18,32,1,2.35,1.153846154,0.923076923,1.384615385,1.192307692,1.153846154,1.230769231,37.74038462,24.51923077,37.74038462,30,86.7,0.6875,Croatia-2-HNL,2022/05/06,2022/04/30 16:00
12,Zmijavci,26,9,5,12,27,37,13,6,3,4,13,11,13,3,2,8,14,26,32,-10,2.46,1.423076923,0.846153846,2,1.038461538,1,1.076923077,37.74038462,24.51923077,37.74038462,30,86.7,0.75,Croatia-2-HNL,2022/05/06,2022/05/08 16:00
12,Zmijavci,26,9,5,12,27,37,13,6,3,4,13,11,13,3,2,8,14,26,32,-10,2.46,1.423076923,0.846153846,2,1.038461538,1,1.076923077,37.74038462,24.51923077,37.74038462,30,86.7,0.75,Croatia-2-HNL,2022/05/06,2022/05/01 16:00
13,Cibalia,26,8,7,11,33,37,13,8,4,1,24,12,13,0,3,10,9,25,31,-4,2.69,1.423076923,0.923076923,1.923076923,1.269230769,1.846153846,0.692307692,37.74038462,24.51923077,37.74038462,30,86.7,0.8125,Croatia-2-HNL,2022/05/06,2022/04/30 16:00
13,Cibalia,26,8,7,11,33,37,13,8,4,1,24,12,13,0,3,10,9,25,31,-4,2.69,1.423076923,0.923076923,1.923076923,1.269230769,1.846153846,0.692307692,37.74038462,24.51923077,37.74038462,30,86.7,0.8125,Croatia-2-HNL,2022/05/06,2022/05/08 16:00
14,Solin,26,8,7,11,30,34,13,7,3,3,19,9,13,1,4,8,11,25,31,-4,2.46,1.307692308,0.692307692,1.923076923,1.153846154,1.461538462,0.846153846,37.74038462,24.51923077,37.74038462,30,86.7,0.875,Croatia-2-HNL,2022/05/06,2022/05/07 16:00
14,Solin,26,8,7,11,30,34,13,7,3,3,19,9,13,1,4,8,11,25,31,-4,2.46,1.307692308,0.692307692,1.923076923,1.153846154,1.461538462,0.846153846,37.74038462,24.51923077,37.74038462,30,86.7,0.875,Croatia-2-HNL,2022/05/06,2022/04/30 16:00
15,Radnik Sesv,26,8,6,12,31,32,13,4,4,5,16,14,13,4,2,7,15,18,30,-1,2.42,1.230769231,1.076923077,1.384615385,1.192307692,1.230769231,1.153846154,37.74038462,24.51923077,37.74038462,30,86.7,0.9375,Croatia-2-HNL,2022/05/06,2022/05/01 16:00
15,Radnik Sesv,26,8,6,12,31,32,13,4,4,5,16,14,13,4,2,7,15,18,30,-1,2.42,1.230769231,1.076923077,1.384615385,1.192307692,1.230769231,1.153846154,37.74038462,24.51923077,37.74038462,30,86.7,0.9375,Croatia-2-HNL,2022/05/06,2022/05/06 15:00
16,Opatija,26,6,6,14,24,38,13,5,4,4,16,13,13,1,2,10,8,25,24,-14,2.38,1.461538462,1,1.923076923,0.923076923,1.230769231,0.615384615,37.74038462,24.51923077,37.74038462,30,86.7,1,Croatia-2-HNL,2022/05/06,2022/05/06 15:00
16,Opatija,26,6,6,14,24,38,13,5,4,4,16,13,13,1,2,10,8,25,24,-14,2.38,1.461538462,1,1.923076923,0.923076923,1.230769231,0.615384615,37.74038462,24.51923077,37.74038462,30,86.7,1,Croatia-2-HNL,2022/05/06,2022/04/30 16:00
1,AEL Limassol,7,5,1,1,10,6,4,2,1,1,5,6,3,3,0,0,5,0,16,4,2.29,0.857142857,1.5,0,1.428571429,1.25,1.666666667,35.71428571,28.57142857,35.71428571,10,70,0.166666667,Cyprus-Division-1,2022/05/06,2022/04/29 17:00
1,AEL Limassol,7,5,1,1,10,6,4,2,1,1,5,6,3,3,0,0,5,0,16,4,2.29,0.857142857,1.5,0,1.428571429,1.25,1.666666667,35.71428571,28.57142857,35.71428571,10,70,0.166666667,Cyprus-Division-1,2022/05/06,2022/04/18 17:00
1,AEL Limassol,7,5,1,1,10,6,4,2,1,1,5,6,3,3,0,0,5,0,16,4,2.29,0.857142857,1.5,0,1.428571429,1.25,1.666666667,35.71428571,28.57142857,35.71428571,10,70,0.166666667,Cyprus-Division-1,2022/05/06,2022/05/07 17:00
2,Olympiakos Ni,7,4,1,2,10,3,3,2,0,1,4,1,4,2,1,1,6,2,13,7,1.86,0.428571429,0.333333333,0.5,1.428571429,1.333333333,1.5,35.71428571,28.57142857,35.71428571,10,70,0.333333333,Cyprus-Division-1,2022/05/06,2022/05/06 17:00
2,Olympiakos Ni,7,4,1,2,10,3,3,2,0,1,4,1,4,2,1,1,6,2,13,7,1.86,0.428571429,0.333333333,0.5,1.428571429,1.333333333,1.5,35.71428571,28.57142857,35.71428571,10,70,0.333333333,Cyprus-Division-1,2022/05/06,2022/04/29 17:00
3,Omonia Nicosia,7,3,3,1,10,8,3,2,1,0,7,4,4,1,2,1,3,4,12,2,2.57,1.142857143,1.333333333,1,1.428571429,2.333333333,0.75,35.71428571,28.57142857,35.71428571,10,70,0.5,Cyprus-Division-1,2022/05/06,2022/05/07 17:00
3,Omonia Nicosia,7,3,3,1,10,8,3,2,1,0,7,4,4,1,2,1,3,4,12,2,2.57,1.142857143,1.333333333,1,1.428571429,2.333333333,0.75,35.71428571,28.57142857,35.71428571,10,70,0.5,Cyprus-Division-1,2022/05/06,2022/04/20 15:00
3,Omonia Nicosia,7,3,3,1,10,8,3,2,1,0,7,4,4,1,2,1,3,4,12,2,2.57,1.142857143,1.333333333,1,1.428571429,2.333333333,0.75,35.71428571,28.57142857,35.71428571,10,70,0.5,Cyprus-Division-1,2022/05/06,2022/05/01 17:00
4,E Achnas Cyp,7,2,3,2,5,3,4,1,3,0,1,0,3,1,0,2,4,3,9,2,1.14,0.428571429,0,1,0.714285714,0.25,1.333333333,35.71428571,28.57142857,35.71428571,10,70,0.666666667,Cyprus-Division-1,2022/05/06,2022/04/20 15:00
4,E Achnas Cyp,7,2,3,2,5,3,4,1,3,0,1,0,3,1,0,2,4,3,9,2,1.14,0.428571429,0,1,0.714285714,0.25,1.333333333,35.71428571,28.57142857,35.71428571,10,70,0.666666667,Cyprus-Division-1,2022/05/06,2022/04/30 16:00
4,E Achnas Cyp,7,2,3,2,5,3,4,1,3,0,1,0,3,1,0,2,4,3,9,2,1.14,0.428571429,0,1,0.714285714,0.25,1.333333333,35.71428571,28.57142857,35.71428571,10,70,0.666666667,Cyprus-Division-1,2022/05/06,2022/05/09 17:00
5,Doxa Cyp,7,1,3,3,6,7,3,0,1,2,1,4,4,1,2,1,5,3,6,-1,1.86,1,1.333333333,0.75,0.857142857,0.333333333,1.25,35.71428571,28.57142857,35.71428571,10,70,0.833333333,Cyprus-Division-1,2022/05/06,2022/05/01 17:00
5,Doxa Cyp,7,1,3,3,6,7,3,0,1,2,1,4,4,1,2,1,5,3,6,-1,1.86,1,1.333333333,0.75,0.857142857,0.333333333,1.25,35.71428571,28.57142857,35.71428571,10,70,0.833333333,Cyprus-Division-1,2022/05/06,2022/05/09 17:00
6,PAEEK,7,0,1,6,3,17,4,0,0,4,0,11,3,0,1,2,3,6,1,-14,2.86,2.428571429,2.75,2,0.428571429,0,1,35.71428571,28.57142857,35.71428571,10,70,1,Cyprus-Division-1,2022/05/06,2022/04/18 17:00
6,PAEEK,7,0,1,6,3,17,4,0,0,4,0,11,3,0,1,2,3,6,1,-14,2.86,2.428571429,2.75,2,0.428571429,0,1,35.71428571,28.57142857,35.71428571,10,70,1,Cyprus-Division-1,2022/05/06,2022/04/30 16:00
6,PAEEK,7,0,1,6,3,17,4,0,0,4,0,11,3,0,1,2,3,6,1,-14,2.86,2.428571429,2.75,2,0.428571429,0,1,35.71428571,28.57142857,35.71428571,10,70,1,Cyprus-Division-1,2022/05/06,2022/05/06 17:00
1,Brno,27,21,2,4,56,24,13,10,2,1,31,17,14,11,0,3,25,7,65,32,2.96,0.888888889,1.307692308,0.5,2.074074074,2.384615385,1.785714286,37.26851852,25.46296296,37.26851852,30,90,0.0625,Czech-FNL,2022/05/06,2022/05/08 16:00
1,Brno,27,21,2,4,56,24,13,10,2,1,31,17,14,11,0,3,25,7,65,32,2.96,0.888888889,1.307692308,0.5,2.074074074,2.384615385,1.785714286,37.26851852,25.46296296,37.26851852,30,90,0.0625,Czech-FNL,2022/05/06,2022/05/01 12:15
2,SK Lisen,27,13,8,6,42,28,14,8,4,2,23,11,13,5,4,4,19,17,47,14,2.59,1.037037037,0.785714286,1.307692308,1.555555556,1.642857143,1.461538462,37.26851852,25.46296296,37.26851852,30,90,0.125,Czech-FNL,2022/05/06,2022/04/30 16:00
2,SK Lisen,27,13,8,6,42,28,14,8,4,2,23,11,13,5,4,4,19,17,47,14,2.59,1.037037037,0.785714286,1.307692308,1.555555556,1.642857143,1.461538462,37.26851852,25.46296296,37.26851852,30,90,0.125,Czech-FNL,2022/05/06,2022/05/07 16:00
3,FC Vlasim,27,14,4,9,53,36,13,9,2,2,30,10,14,5,2,7,23,26,46,17,3.3,1.333333333,0.769230769,1.857142857,1.962962963,2.307692308,1.642857143,37.26851852,25.46296296,37.26851852,30,90,0.1875,Czech-FNL,2022/05/06,2022/05/01 12:15
3,FC Vlasim,27,14,4,9,53,36,13,9,2,2,30,10,14,5,2,7,23,26,46,17,3.3,1.333333333,0.769230769,1.857142857,1.962962963,2.307692308,1.642857143,37.26851852,25.46296296,37.26851852,30,90,0.1875,Czech-FNL,2022/05/06,2022/05/06 16:30
4,Sparta Pr 2,27,13,6,8,47,32,13,8,2,3,29,15,14,5,4,5,18,17,45,15,2.93,1.185185185,1.153846154,1.214285714,1.740740741,2.230769231,1.285714286,37.26851852,25.46296296,37.26851852,30,90,0.25,Czech-FNL,2022/05/06,2022/05/06 16:00
5,Opava,27,12,9,6,42,29,14,8,5,1,26,11,13,4,4,5,16,18,45,13,2.63,1.074074074,0.785714286,1.384615385,1.555555556,1.857142857,1.230769231,37.26851852,25.46296296,37.26851852,30,90,0.3125,Czech-FNL,2022/05/06,2022/04/30 16:00
5,Opava,27,12,9,6,42,29,14,8,5,1,26,11,13,4,4,5,16,18,45,13,2.63,1.074074074,0.785714286,1.384615385,1.555555556,1.857142857,1.230769231,37.26851852,25.46296296,37.26851852,30,90,0.3125,Czech-FNL,2022/05/06,2022/05/06 16:00
6,Sl Varnsdorf,27,11,5,11,41,35,13,8,0,5,26,17,14,3,5,6,15,18,38,6,2.81,1.296296296,1.307692308,1.285714286,1.518518519,2,1.071428571,37.26851852,25.46296296,37.26851852,30,90,0.375,Czech-FNL,2022/05/06,2022/05/08 16:00
6,Sl Varnsdorf,27,11,5,11,41,35,13,8,0,5,26,17,14,3,5,6,15,18,38,6,2.81,1.296296296,1.307692308,1.285714286,1.518518519,2,1.071428571,37.26851852,25.46296296,37.26851852,30,90,0.375,Czech-FNL,2022/05/06,2022/04/30 16:00
7,Vys Jihlava,27,10,8,9,26,31,14,7,3,4,14,13,13,3,5,5,12,18,38,-5,2.11,1.148148148,0.928571429,1.384615385,0.962962963,1,0.923076923,37.26851852,25.46296296,37.26851852,30,90,0.4375,Czech-FNL,2022/05/06,2022/05/01 17:00
7,Vys Jihlava,27,10,8,9,26,31,14,7,3,4,14,13,13,3,5,5,12,18,38,-5,2.11,1.148148148,0.928571429,1.384615385,0.962962963,1,0.923076923,37.26851852,25.46296296,37.26851852,30,90,0.4375,Czech-FNL,2022/05/06,2022/05/07 09:15
8,Dukla Praha,27,10,7,10,37,37,14,6,3,5,22,16,13,4,4,5,15,21,37,0,2.74,1.37037037,1.142857143,1.615384615,1.37037037,1.571428571,1.153846154,37.26851852,25.46296296,37.26851852,30,90,0.5,Czech-FNL,2022/05/06,2022/05/08 16:00
9,MAS Taborsko,27,9,9,9,31,31,14,6,4,4,19,14,13,3,5,5,12,17,36,0,2.3,1.148148148,1,1.307692308,1.148148148,1.357142857,0.923076923,37.26851852,25.46296296,37.26851852,30,90,0.5625,Czech-FNL,2022/05/06,2022/05/01 16:00
9,MAS Taborsko,27,9,9,9,31,31,14,6,4,4,19,14,13,3,5,5,12,17,36,0,2.3,1.148148148,1,1.307692308,1.148148148,1.357142857,0.923076923,37.26851852,25.46296296,37.26851852,30,90,0.5625,Czech-FNL,2022/05/06,2022/05/04 16:00
9,MAS Taborsko,27,9,9,9,31,31,14,6,4,4,19,14,13,3,5,5,12,17,36,0,2.3,1.148148148,1,1.307692308,1.148148148,1.357142857,0.923076923,37.26851852,25.46296296,37.26851852,30,90,0.5625,Czech-FNL,2022/05/06,2022/05/08 16:00
10,Prostejov,27,10,3,14,27,43,14,8,2,4,21,16,13,2,1,10,6,27,33,-16,2.59,1.592592593,1.142857143,2.076923077,1,1.5,0.461538462,37.26851852,25.46296296,37.26851852,30,90,0.625,Czech-FNL,2022/05/06,2022/04/30 16:00
10,Prostejov,27,10,3,14,27,43,14,8,2,4,21,16,13,2,1,10,6,27,33,-16,2.59,1.592592593,1.142857143,2.076923077,1,1.5,0.461538462,37.26851852,25.46296296,37.26851852,30,90,0.625,Czech-FNL,2022/05/06,2022/05/08 09:15
11,Pribram,27,8,8,11,33,44,13,4,3,6,14,18,14,4,5,5,19,26,32,-11,2.85,1.62962963,1.384615385,1.857142857,1.222222222,1.076923077,1.357142857,37.26851852,25.46296296,37.26851852,30,90,0.6875,Czech-FNL,2022/05/06,2022/05/07 16:00
12,Vyskov,27,8,7,12,40,41,13,6,2,5,22,16,14,2,5,7,18,25,31,-1,3,1.518518519,1.230769231,1.785714286,1.481481481,1.692307692,1.285714286,37.26851852,25.46296296,37.26851852,30,90,0.75,Czech-FNL,2022/05/06,2022/05/07 09:15
12,Vyskov,27,8,7,12,40,41,13,6,2,5,22,16,14,2,5,7,18,25,31,-1,3,1.518518519,1.230769231,1.785714286,1.481481481,1.692307692,1.285714286,37.26851852,25.46296296,37.26851852,30,90,0.75,Czech-FNL,2022/05/06,2022/04/30 09:15
13,Chrudim,27,7,10,10,24,32,14,4,7,3,12,9,13,3,3,7,12,23,31,-8,2.07,1.185185185,0.642857143,1.769230769,0.888888889,0.857142857,0.923076923,37.26851852,25.46296296,37.26851852,30,90,0.8125,Czech-FNL,2022/05/06,2022/04/30 09:15
13,Chrudim,27,7,10,10,24,32,14,4,7,3,12,9,13,3,3,7,12,23,31,-8,2.07,1.185185185,0.642857143,1.769230769,0.888888889,0.857142857,0.923076923,37.26851852,25.46296296,37.26851852,30,90,0.8125,Czech-FNL,2022/05/06,2022/05/04 16:00
13,Chrudim,27,7,10,10,24,32,14,4,7,3,12,9,13,3,3,7,12,23,31,-8,2.07,1.185185185,0.642857143,1.769230769,0.888888889,0.857142857,0.923076923,37.26851852,25.46296296,37.26851852,30,90,0.8125,Czech-FNL,2022/05/06,2022/05/07 16:00
14,Trinec Fotbal,27,8,6,13,34,47,14,6,3,5,23,17,13,2,3,8,11,30,30,-13,3,1.740740741,1.214285714,2.307692308,1.259259259,1.642857143,0.846153846,37.26851852,25.46296296,37.26851852,30,90,0.875,Czech-FNL,2022/05/06,2022/05/06 16:30
15,Usti n Labem,27,5,10,12,23,42,13,2,7,4,15,23,14,3,3,8,8,19,25,-19,2.41,1.555555556,1.769230769,1.357142857,0.851851852,1.153846154,0.571428571,37.26851852,25.46296296,37.26851852,30,90,0.9375,Czech-FNL,2022/05/06,2022/05/07 16:00
15,Usti n Labem,27,5,10,12,23,42,13,2,7,4,15,23,14,3,3,8,8,19,25,-19,2.41,1.555555556,1.769230769,1.357142857,0.851851852,1.153846154,0.571428571,37.26851852,25.46296296,37.26851852,30,90,0.9375,Czech-FNL,2022/05/06,2022/05/01 16:00
16,Zizkov,27,2,8,17,25,49,13,1,6,6,11,20,14,1,2,11,14,29,14,-24,2.74,1.814814815,1.538461538,2.071428571,0.925925926,0.846153846,1,37.26851852,25.46296296,37.26851852,30,90,1,Czech-FNL,2022/05/06,2022/05/08 09:15
16,Zizkov,27,2,8,17,25,49,13,1,6,6,11,20,14,1,2,11,14,29,14,-24,2.74,1.814814815,1.538461538,2.071428571,0.925925926,0.846153846,1,37.26851852,25.46296296,37.26851852,30,90,1,Czech-FNL,2022/05/06,2022/05/01 17:00
1,Horsens,5,4,1,0,7,3,2,1,1,0,3,2,3,3,0,0,4,1,13,4,2,0.6,1,0.333333333,1.4,1.5,1.333333333,43.33333333,13.33333333,43.33333333,10,50,0.166666667,Denmark-Division-1,2022/05/06,2022/04/24 14:00
1,Horsens,5,4,1,0,7,3,2,1,1,0,3,2,3,3,0,0,4,1,13,4,2,0.6,1,0.333333333,1.4,1.5,1.333333333,43.33333333,13.33333333,43.33333333,10,50,0.166666667,Denmark-Division-1,2022/05/06,2022/05/06 17:30
1,Horsens,5,4,1,0,7,3,2,1,1,0,3,2,3,3,0,0,4,1,13,4,2,0.6,1,0.333333333,1.4,1.5,1.333333333,43.33333333,13.33333333,43.33333333,10,50,0.166666667,Denmark-Division-1,2022/05/06,2022/04/29 17:30
2,Lyngby,5,3,1,1,11,4,3,2,0,1,8,3,2,1,1,0,3,1,10,7,3,0.8,1,0.5,2.2,2.666666667,1.5,43.33333333,13.33333333,43.33333333,10,50,0.333333333,Denmark-Division-1,2022/05/06,2022/04/30 11:45
2,Lyngby,5,3,1,1,11,4,3,2,0,1,8,3,2,1,1,0,3,1,10,7,3,0.8,1,0.5,2.2,2.666666667,1.5,43.33333333,13.33333333,43.33333333,10,50,0.333333333,Denmark-Division-1,2022/05/06,2022/05/06 17:30
3,Fredericia,5,3,1,1,10,6,3,2,0,1,7,4,2,1,1,0,3,2,10,4,3.2,1.2,1.333333333,1,2,2.333333333,1.5,43.33333333,13.33333333,43.33333333,10,50,0.5,Denmark-Division-1,2022/05/06,2022/04/30 14:00
3,Fredericia,5,3,1,1,10,6,3,2,0,1,7,4,2,1,1,0,3,2,10,4,3.2,1.2,1.333333333,1,2,2.333333333,1.5,43.33333333,13.33333333,43.33333333,10,50,0.5,Denmark-Division-1,2022/05/06,2022/05/06 18:00
4,Hvidovre,5,2,1,2,5,4,3,1,1,1,2,1,2,1,0,1,3,3,7,1,1.8,0.8,0.333333333,1.5,1,0.666666667,1.5,43.33333333,13.33333333,43.33333333,10,50,0.666666667,Denmark-Division-1,2022/05/06,2022/04/29 17:30
4,Hvidovre,5,2,1,2,5,4,3,1,1,1,2,1,2,1,0,1,3,3,7,1,1.8,0.8,0.333333333,1.5,1,0.666666667,1.5,43.33333333,13.33333333,43.33333333,10,50,0.666666667,Denmark-Division-1,2022/05/06,2022/05/07 14:00
5,Lolland FA,5,1,0,4,8,16,2,1,0,1,6,6,3,0,0,3,2,10,3,-8,4.8,3.2,3,3.333333333,1.6,3,0.666666667,43.33333333,13.33333333,43.33333333,10,50,0.833333333,Denmark-Division-1,2022/05/06,2022/04/30 14:00
5,Lolland FA,5,1,0,4,8,16,2,1,0,1,6,6,3,0,0,3,2,10,3,-8,4.8,3.2,3,3.333333333,1.6,3,0.666666667,43.33333333,13.33333333,43.33333333,10,50,0.833333333,Denmark-Division-1,2022/05/06,2022/05/07 14:00
5,Lolland FA,5,1,0,4,8,16,2,1,0,1,6,6,3,0,0,3,2,10,3,-8,4.8,3.2,3,3.333333333,1.6,3,0.666666667,43.33333333,13.33333333,43.33333333,10,50,0.833333333,Denmark-Division-1,2022/05/06,2022/04/24 14:00
6,Helsingor,5,0,0,5,5,13,2,0,0,2,1,3,3,0,0,3,4,10,0,-8,3.6,2.6,1.5,3.333333333,1,0.5,1.333333333,43.33333333,13.33333333,43.33333333,10,50,1,Denmark-Division-1,2022/05/06,2022/05/06 18:00
6,Helsingor,5,0,0,5,5,13,2,0,0,2,1,3,3,0,0,3,4,10,0,-8,3.6,2.6,1.5,3.333333333,1,0.5,1.333333333,43.33333333,13.33333333,43.33333333,10,50,1,Denmark-Division-1,2022/05/06,2022/04/30 11:45
1,Thisted,3,2,1,0,5,2,1,1,0,0,2,1,2,1,1,0,3,1,7,3,2.33,0.666666667,1,0.5,1.666666667,2,1.5,38.88888889,22.22222222,38.88888889,10,30,0.166666667,Denmark-Division-2,2022/05/06,2022/05/08 13:00
1,Thisted,3,2,1,0,5,2,1,1,0,0,2,1,2,1,1,0,3,1,7,3,2.33,0.666666667,1,0.5,1.666666667,2,1.5,38.88888889,22.22222222,38.88888889,10,30,0.166666667,Denmark-Division-2,2022/05/06,2022/04/24 12:00
1,Thisted,3,2,1,0,5,2,1,1,0,0,2,1,2,1,1,0,3,1,7,3,2.33,0.666666667,1,0.5,1.666666667,2,1.5,38.88888889,22.22222222,38.88888889,10,30,0.166666667,Denmark-Division-2,2022/05/06,2022/04/30 13:00
2,Naestved,3,2,1,0,4,2,1,0,1,0,1,1,2,2,0,0,3,1,7,2,2,0.666666667,1,0.5,1.333333333,1,1.5,38.88888889,22.22222222,38.88888889,10,30,0.333333333,Denmark-Division-2,2022/05/06,2022/04/24 12:00
2,Naestved,3,2,1,0,4,2,1,0,1,0,1,1,2,2,0,0,3,1,7,2,2,0.666666667,1,0.5,1.333333333,1,1.5,38.88888889,22.22222222,38.88888889,10,30,0.333333333,Denmark-Division-2,2022/05/06,2022/05/08 12:00
2,Naestved,3,2,1,0,4,2,1,0,1,0,1,1,2,2,0,0,3,1,7,2,2,0.666666667,1,0.5,1.333333333,1,1.5,38.88888889,22.22222222,38.88888889,10,30,0.333333333,Denmark-Division-2,2022/05/06,2022/05/01 12:00
3,AB Gladsaxe,3,1,1,1,4,2,2,1,0,1,3,1,1,0,1,0,1,1,4,2,2,0.666666667,0.5,1,1.333333333,1.5,1,38.88888889,22.22222222,38.88888889,10,30,0.5,Denmark-Division-2,2022/05/06,2022/05/01 12:00
3,AB Gladsaxe,3,1,1,1,4,2,2,1,0,1,3,1,1,0,1,0,1,1,4,2,2,0.666666667,0.5,1,1.333333333,1.5,1,38.88888889,22.22222222,38.88888889,10,30,0.5,Denmark-Division-2,2022/05/06,2022/05/08 13:00
4,HIK,3,1,0,2,4,5,2,0,0,2,1,4,1,1,0,0,3,1,3,-1,3,1.666666667,2,1,1.333333333,0.5,3,38.88888889,22.22222222,38.88888889,10,30,0.666666667,Denmark-Division-2,2022/05/06,2022/04/30 13:00
4,HIK,3,1,0,2,4,5,2,0,0,2,1,4,1,1,0,0,3,1,3,-1,3,1.666666667,2,1,1.333333333,0.5,3,38.88888889,22.22222222,38.88888889,10,30,0.666666667,Denmark-Division-2,2022/05/06,2022/04/23 14:00
4,HIK,3,1,0,2,4,5,2,0,0,2,1,4,1,1,0,0,3,1,3,-1,3,1.666666667,2,1,1.333333333,0.5,3,38.88888889,22.22222222,38.88888889,10,30,0.666666667,Denmark-Division-2,2022/05/06,2022/05/06 18:00
5,Hillerod,3,1,0,2,4,8,2,1,0,1,4,5,1,0,0,1,0,3,3,-4,4,2.666666667,2.5,3,1.333333333,2,0,38.88888889,22.22222222,38.88888889,10,30,0.833333333,Denmark-Division-2,2022/05/06,2022/04/23 14:00
5,Hillerod,3,1,0,2,4,8,2,1,0,1,4,5,1,0,0,1,0,3,3,-4,4,2.666666667,2.5,3,1.333333333,2,0,38.88888889,22.22222222,38.88888889,10,30,0.833333333,Denmark-Division-2,2022/05/06,2022/04/30 13:00
5,Hillerod,3,1,0,2,4,8,2,1,0,1,4,5,1,0,0,1,0,3,3,-4,4,2.666666667,2.5,3,1.333333333,2,0,38.88888889,22.22222222,38.88888889,10,30,0.833333333,Denmark-Division-2,2022/05/06,2022/05/08 12:00
6,B93 Kobenhavn,3,0,1,2,4,6,1,0,1,0,1,1,2,0,0,2,3,5,1,-2,3.33,2,1,2.5,1.333333333,1,1.5,38.88888889,22.22222222,38.88888889,10,30,1,Denmark-Division-2,2022/05/06,2022/05/06 18:00
6,B93 Kobenhavn,3,0,1,2,4,6,1,0,1,0,1,1,2,0,0,2,3,5,1,-2,3.33,2,1,2.5,1.333333333,1,1.5,38.88888889,22.22222222,38.88888889,10,30,1,Denmark-Division-2,2022/05/06,2022/04/30 13:00
1,Silkeborg,6,5,0,1,16,8,3,3,0,0,10,3,3,2,0,1,6,5,15,8,4,1.333333333,1,1.666666667,2.666666667,3.333333333,2,47.22222222,5.555555556,47.22222222,10,60,0.166666667,Denmark-Superliga,2022/05/06,2022/05/02 18:00
1,Silkeborg,6,5,0,1,16,8,3,3,0,0,10,3,3,2,0,1,6,5,15,8,4,1.333333333,1,1.666666667,2.666666667,3.333333333,2,47.22222222,5.555555556,47.22222222,10,60,0.166666667,Denmark-Superliga,2022/05/06,2022/05/06 18:00
2,Midtjylland,6,4,1,1,11,5,3,2,1,0,5,2,3,2,0,1,6,3,13,6,2.67,0.833333333,0.666666667,1,1.833333333,1.666666667,2,47.22222222,5.555555556,47.22222222,10,60,0.333333333,Denmark-Superliga,2022/05/06,2022/05/01 17:00
2,Midtjylland,6,4,1,1,11,5,3,2,1,0,5,2,3,2,0,1,6,3,13,6,2.67,0.833333333,0.666666667,1,1.833333333,1.666666667,2,47.22222222,5.555555556,47.22222222,10,60,0.333333333,Denmark-Superliga,2022/05/06,2022/04/25 18:00
2,Midtjylland,6,4,1,1,11,5,3,2,1,0,5,2,3,2,0,1,6,3,13,6,2.67,0.833333333,0.666666667,1,1.833333333,1.666666667,2,47.22222222,5.555555556,47.22222222,10,60,0.333333333,Denmark-Superliga,2022/05/06,2022/05/08 17:00
3,FC Kobenhavn,6,3,1,2,5,4,3,2,0,1,3,1,3,1,1,1,2,3,10,1,1.5,0.666666667,0.333333333,1,0.833333333,1,0.666666667,47.22222222,5.555555556,47.22222222,10,60,0.5,Denmark-Superliga,2022/05/06,2022/04/24 15:00
3,FC Kobenhavn,6,3,1,2,5,4,3,2,0,1,3,1,3,1,1,1,2,3,10,1,1.5,0.666666667,0.333333333,1,0.833333333,1,0.666666667,47.22222222,5.555555556,47.22222222,10,60,0.5,Denmark-Superliga,2022/05/06,2022/05/01 17:00
3,FC Kobenhavn,6,3,1,2,5,4,3,2,0,1,3,1,3,1,1,1,2,3,10,1,1.5,0.666666667,0.333333333,1,0.833333333,1,0.666666667,47.22222222,5.555555556,47.22222222,10,60,0.5,Denmark-Superliga,2022/05/06,2022/05/08 15:00
4,Randers,6,3,0,3,6,9,3,1,0,2,4,6,3,2,0,1,2,3,9,-3,2.5,1.5,2,1,1,1.333333333,0.666666667,47.22222222,5.555555556,47.22222222,10,60,0.666666667,Denmark-Superliga,2022/05/06,2022/05/01 15:00
4,Randers,6,3,0,3,6,9,3,1,0,2,4,6,3,2,0,1,2,3,9,-3,2.5,1.5,2,1,1,1.333333333,0.666666667,47.22222222,5.555555556,47.22222222,10,60,0.666666667,Denmark-Superliga,2022/05/06,2022/04/24 15:00
4,Randers,6,3,0,3,6,9,3,1,0,2,4,6,3,2,0,1,2,3,9,-3,2.5,1.5,2,1,1,1.333333333,0.666666667,47.22222222,5.555555556,47.22222222,10,60,0.666666667,Denmark-Superliga,2022/05/06,2022/05/06 18:00
5,AaB Aalborg,6,2,0,4,7,9,3,1,0,2,4,3,3,1,0,2,3,6,6,-2,2.67,1.5,1,2,1.166666667,1.333333333,1,47.22222222,5.555555556,47.22222222,10,60,0.833333333,Denmark-Superliga,2022/05/06,2022/05/08 17:00
5,AaB Aalborg,6,2,0,4,7,9,3,1,0,2,4,3,3,1,0,2,3,6,6,-2,2.67,1.5,1,2,1.166666667,1.333333333,1,47.22222222,5.555555556,47.22222222,10,60,0.833333333,Denmark-Superliga,2022/05/06,2022/05/02 18:00
6,Brondby,6,0,0,6,2,12,3,0,0,3,1,5,3,0,0,3,1,7,0,-10,2.33,2,1.666666667,2.333333333,0.333333333,0.333333333,0.333333333,47.22222222,5.555555556,47.22222222,10,60,1,Denmark-Superliga,2022/05/06,2022/04/25 18:00
6,Brondby,6,0,0,6,2,12,3,0,0,3,1,5,3,0,0,3,1,7,0,-10,2.33,2,1.666666667,2.333333333,0.333333333,0.333333333,0.333333333,47.22222222,5.555555556,47.22222222,10,60,1,Denmark-Superliga,2022/05/06,2022/05/08 15:00
6,Brondby,6,0,0,6,2,12,3,0,0,3,1,5,3,0,0,3,1,7,0,-10,2.33,2,1.666666667,2.333333333,0.333333333,0.333333333,0.333333333,47.22222222,5.555555556,47.22222222,10,60,1,Denmark-Superliga,2022/05/06,2022/05/01 15:00
1,Flora Tallinn,11,11,0,0,32,7,5,5,0,0,15,3,6,6,0,0,17,4,33,25,3.55,0.636363636,0.6,0.666666667,2.909090909,3,2.833333333,45.45454545,9.090909091,45.45454545,18,61.1,0.1,Estonia-Meistriliiga,2022/05/06,2022/05/01 15:15
1,Flora Tallinn,11,11,0,0,32,7,5,5,0,0,15,3,6,6,0,0,17,4,33,25,3.55,0.636363636,0.6,0.666666667,2.909090909,3,2.833333333,45.45454545,9.090909091,45.45454545,18,61.1,0.1,Estonia-Meistriliiga,2022/05/06,2022/05/08 15:15
1,Flora Tallinn,11,11,0,0,32,7,5,5,0,0,15,3,6,6,0,0,17,4,33,25,3.55,0.636363636,0.6,0.666666667,2.909090909,3,2.833333333,45.45454545,9.090909091,45.45454545,18,61.1,0.1,Estonia-Meistriliiga,2022/05/06,2022/04/27 16:00
2,FCI Levadia,11,9,1,1,30,4,6,5,1,0,19,2,5,4,0,1,11,2,28,26,3.09,0.363636364,0.333333333,0.4,2.727272727,3.166666667,2.2,45.45454545,9.090909091,45.45454545,18,61.1,0.2,Estonia-Meistriliiga,2022/05/06,2022/04/30 17:30
2,FCI Levadia,11,9,1,1,30,4,6,5,1,0,19,2,5,4,0,1,11,2,28,26,3.09,0.363636364,0.333333333,0.4,2.727272727,3.166666667,2.2,45.45454545,9.090909091,45.45454545,18,61.1,0.2,Estonia-Meistriliiga,2022/05/06,2022/04/27 15:30
2,FCI Levadia,11,9,1,1,30,4,6,5,1,0,19,2,5,4,0,1,11,2,28,26,3.09,0.363636364,0.333333333,0.4,2.727272727,3.166666667,2.2,45.45454545,9.090909091,45.45454545,18,61.1,0.2,Estonia-Meistriliiga,2022/05/06,2022/05/07 15:00
3,Nomme Kalju,11,8,2,1,23,9,6,5,0,1,13,3,5,3,2,0,10,6,26,14,2.91,0.818181818,0.5,1.2,2.090909091,2.166666667,2,45.45454545,9.090909091,45.45454545,18,61.1,0.3,Estonia-Meistriliiga,2022/05/06,2022/04/26 18:00
3,Nomme Kalju,11,8,2,1,23,9,6,5,0,1,13,3,5,3,2,0,10,6,26,14,2.91,0.818181818,0.5,1.2,2.090909091,2.166666667,2,45.45454545,9.090909091,45.45454545,18,61.1,0.3,Estonia-Meistriliiga,2022/05/06,2022/05/08 12:30
3,Nomme Kalju,11,8,2,1,23,9,6,5,0,1,13,3,5,3,2,0,10,6,26,14,2.91,0.818181818,0.5,1.2,2.090909091,2.166666667,2,45.45454545,9.090909091,45.45454545,18,61.1,0.3,Estonia-Meistriliiga,2022/05/06,2022/04/30 15:00
4,Flora Paide,11,7,0,4,33,13,6,3,0,3,21,8,5,4,0,1,12,5,21,20,4.18,1.181818182,1.333333333,1,3,3.5,2.4,45.45454545,9.090909091,45.45454545,18,61.1,0.4,Estonia-Meistriliiga,2022/05/06,2022/04/27 17:30
4,Flora Paide,11,7,0,4,33,13,6,3,0,3,21,8,5,4,0,1,12,5,21,20,4.18,1.181818182,1.333333333,1,3,3.5,2.4,45.45454545,9.090909091,45.45454545,18,61.1,0.4,Estonia-Meistriliiga,2022/05/06,2022/05/01 12:30
4,Flora Paide,11,7,0,4,33,13,6,3,0,3,21,8,5,4,0,1,12,5,21,20,4.18,1.181818182,1.333333333,1,3,3.5,2.4,45.45454545,9.090909091,45.45454545,18,61.1,0.4,Estonia-Meistriliiga,2022/05/06,2022/05/08 15:15
5,Kuressaare,11,5,1,5,13,14,5,3,0,2,7,8,6,2,1,3,6,6,16,-1,2.45,1.272727273,1.6,1,1.181818182,1.4,1,45.45454545,9.090909091,45.45454545,18,61.1,0.5,Estonia-Meistriliiga,2022/05/06,2022/04/29 17:00
5,Kuressaare,11,5,1,5,13,14,5,3,0,2,7,8,6,2,1,3,6,6,16,-1,2.45,1.272727273,1.6,1,1.181818182,1.4,1,45.45454545,9.090909091,45.45454545,18,61.1,0.5,Estonia-Meistriliiga,2022/05/06,2022/04/26 16:00
5,Kuressaare,11,5,1,5,13,14,5,3,0,2,7,8,6,2,1,3,6,6,16,-1,2.45,1.272727273,1.6,1,1.181818182,1.4,1,45.45454545,9.090909091,45.45454545,18,61.1,0.5,Estonia-Meistriliiga,2022/05/06,2022/05/06 17:00
6,Trans Narva,11,4,0,7,13,18,6,2,0,4,9,7,5,2,0,3,4,11,12,-5,2.82,1.636363636,1.166666667,2.2,1.181818182,1.5,0.8,45.45454545,9.090909091,45.45454545,18,61.1,0.6,Estonia-Meistriliiga,2022/05/06,2022/04/26 16:00
6,Trans Narva,11,4,0,7,13,18,6,2,0,4,9,7,5,2,0,3,4,11,12,-5,2.82,1.636363636,1.166666667,2.2,1.181818182,1.5,0.8,45.45454545,9.090909091,45.45454545,18,61.1,0.6,Estonia-Meistriliiga,2022/05/06,2022/04/30 17:30
6,Trans Narva,11,4,0,7,13,18,6,2,0,4,9,7,5,2,0,3,4,11,12,-5,2.82,1.636363636,1.166666667,2.2,1.181818182,1.5,0.8,45.45454545,9.090909091,45.45454545,18,61.1,0.6,Estonia-Meistriliiga,2022/05/06,2022/05/07 17:30
7,JK Tammeka,11,3,2,6,10,19,5,1,1,3,3,9,6,2,1,3,7,10,11,-9,2.64,1.727272727,1.8,1.666666667,0.909090909,0.6,1.166666667,45.45454545,9.090909091,45.45454545,18,61.1,0.7,Estonia-Meistriliiga,2022/05/06,2022/04/27 15:30
7,JK Tammeka,11,3,2,6,10,19,5,1,1,3,3,9,6,2,1,3,7,10,11,-9,2.64,1.727272727,1.8,1.666666667,0.909090909,0.6,1.166666667,45.45454545,9.090909091,45.45454545,18,61.1,0.7,Estonia-Meistriliiga,2022/05/06,2022/05/01 15:15
7,JK Tammeka,11,3,2,6,10,19,5,1,1,3,3,9,6,2,1,3,7,10,11,-9,2.64,1.727272727,1.8,1.666666667,0.909090909,0.6,1.166666667,45.45454545,9.090909091,45.45454545,18,61.1,0.7,Estonia-Meistriliiga,2022/05/06,2022/05/08 12:30
8,TJK Legion,11,1,3,7,9,23,6,1,3,2,9,10,5,0,0,5,0,13,6,-14,2.91,2.090909091,1.666666667,2.6,0.818181818,1.5,0,45.45454545,9.090909091,45.45454545,18,61.1,0.8,Estonia-Meistriliiga,2022/05/06,2022/05/07 17:30
8,TJK Legion,11,1,3,7,9,23,6,1,3,2,9,10,5,0,0,5,0,13,6,-14,2.91,2.090909091,1.666666667,2.6,0.818181818,1.5,0,45.45454545,9.090909091,45.45454545,18,61.1,0.8,Estonia-Meistriliiga,2022/05/06,2022/04/26 18:00
8,TJK Legion,11,1,3,7,9,23,6,1,3,2,9,10,5,0,0,5,0,13,6,-14,2.91,2.090909091,1.666666667,2.6,0.818181818,1.5,0,45.45454545,9.090909091,45.45454545,18,61.1,0.8,Estonia-Meistriliiga,2022/05/06,2022/04/29 17:00
9,Tallinna Kal,11,1,1,9,8,40,4,1,0,3,3,10,7,0,1,6,5,30,4,-32,4.36,3.636363636,2.5,4.285714286,0.727272727,0.75,0.714285714,45.45454545,9.090909091,45.45454545,18,61.1,0.9,Estonia-Meistriliiga,2022/05/06,2022/04/27 16:00
9,Tallinna Kal,11,1,1,9,8,40,4,1,0,3,3,10,7,0,1,6,5,30,4,-32,4.36,3.636363636,2.5,4.285714286,0.727272727,0.75,0.714285714,45.45454545,9.090909091,45.45454545,18,61.1,0.9,Estonia-Meistriliiga,2022/05/06,2022/05/07 15:00
9,Tallinna Kal,11,1,1,9,8,40,4,1,0,3,3,10,7,0,1,6,5,30,4,-32,4.36,3.636363636,2.5,4.285714286,0.727272727,0.75,0.714285714,45.45454545,9.090909091,45.45454545,18,61.1,0.9,Estonia-Meistriliiga,2022/05/06,2022/05/01 12:30
10,Vaprus Parnu,11,1,0,10,10,34,6,1,0,5,5,17,5,0,0,5,5,17,3,-24,4,3.090909091,2.833333333,3.4,0.909090909,0.833333333,1,45.45454545,9.090909091,45.45454545,18,61.1,1,Estonia-Meistriliiga,2022/05/06,2022/04/30 15:00
10,Vaprus Parnu,11,1,0,10,10,34,6,1,0,5,5,17,5,0,0,5,5,17,3,-24,4,3.090909091,2.833333333,3.4,0.909090909,0.833333333,1,45.45454545,9.090909091,45.45454545,18,61.1,1,Estonia-Meistriliiga,2022/05/06,2022/05/06 17:00
10,Vaprus Parnu,11,1,0,10,10,34,6,1,0,5,5,17,5,0,0,5,5,17,3,-24,4,3.090909091,2.833333333,3.4,0.909090909,0.833333333,1,45.45454545,9.090909091,45.45454545,18,61.1,1,Estonia-Meistriliiga,2022/05/06,2022/04/27 17:30
1,Laval,32,20,6,6,46,26,16,10,2,4,21,11,16,10,4,2,25,15,66,20,2.25,0.8125,0.6875,0.9375,1.4375,1.3125,1.5625,36.75958188,26.48083624,36.75958188,34,94.1,0.055555556,France-National,2022/05/06,2022/05/06 17:30
1,Laval,32,20,6,6,46,26,16,10,2,4,21,11,16,10,4,2,25,15,66,20,2.25,0.8125,0.6875,0.9375,1.4375,1.3125,1.5625,36.75958188,26.48083624,36.75958188,34,94.1,0.055555556,France-National,2022/05/06,2022/05/02 17:45
2,Annecy,32,18,9,5,53,27,16,11,4,1,33,9,16,7,5,4,20,18,63,26,2.5,0.84375,0.5625,1.125,1.65625,2.0625,1.25,36.75958188,26.48083624,36.75958188,34,94.1,0.111111111,France-National,2022/05/06,2022/04/29 18:00
2,Annecy,32,18,9,5,53,27,16,11,4,1,33,9,16,7,5,4,20,18,63,26,2.5,0.84375,0.5625,1.125,1.65625,2.0625,1.25,36.75958188,26.48083624,36.75958188,34,94.1,0.111111111,France-National,2022/05/06,2022/05/06 17:30
3,Villefranc,32,17,8,7,42,28,16,9,3,4,22,15,16,8,5,3,20,13,59,14,2.19,0.875,0.9375,0.8125,1.3125,1.375,1.25,36.75958188,26.48083624,36.75958188,34,94.1,0.166666667,France-National,2022/05/06,2022/05/06 17:30
4,Concarneau,32,14,13,5,43,26,16,9,4,3,22,11,16,5,9,2,21,15,55,17,2.16,0.8125,0.6875,0.9375,1.34375,1.375,1.3125,36.75958188,26.48083624,36.75958188,34,94.1,0.222222222,France-National,2022/05/06,2022/05/06 17:30
4,Concarneau,32,14,13,5,43,26,16,9,4,3,22,11,16,5,9,2,21,15,55,17,2.16,0.8125,0.6875,0.9375,1.34375,1.375,1.3125,36.75958188,26.48083624,36.75958188,34,94.1,0.222222222,France-National,2022/05/06,2022/04/29 18:00
5,Bourg Peronn,32,14,9,9,51,33,16,7,5,4,22,14,16,7,4,5,29,19,51,18,2.62,1.03125,0.875,1.1875,1.59375,1.375,1.8125,36.75958188,26.48083624,36.75958188,34,94.1,0.277777778,France-National,2022/05/06,2022/05/06 17:30
6,Chateauroux,32,14,9,9,40,28,16,8,5,3,25,13,16,6,4,6,15,15,51,12,2.12,0.875,0.8125,0.9375,1.25,1.5625,0.9375,36.75958188,26.48083624,36.75958188,34,94.1,0.333333333,France-National,2022/05/06,2022/05/06 17:30
7,Std Briochin,32,13,9,10,42,33,16,9,3,4,23,14,16,4,6,6,19,19,48,9,2.34,1.03125,0.875,1.1875,1.3125,1.4375,1.1875,36.75958188,26.48083624,36.75958188,34,94.1,0.388888889,France-National,2022/05/06,2022/04/29 18:00
7,Std Briochin,32,13,9,10,42,33,16,9,3,4,23,14,16,4,6,6,19,19,48,9,2.34,1.03125,0.875,1.1875,1.3125,1.4375,1.1875,36.75958188,26.48083624,36.75958188,34,94.1,0.388888889,France-National,2022/05/06,2022/05/06 17:30
8,Sedan,32,12,11,9,36,35,16,8,4,4,18,14,16,4,7,5,18,21,47,1,2.22,1.09375,0.875,1.3125,1.125,1.125,1.125,36.75958188,26.48083624,36.75958188,34,94.1,0.444444444,France-National,2022/05/06,2022/05/06 17:30
9,Le Mans,32,12,9,11,32,30,16,8,4,4,18,12,16,4,5,7,14,18,45,2,1.94,0.9375,0.75,1.125,1,1.125,0.875,36.75958188,26.48083624,36.75958188,34,94.1,0.5,France-National,2022/05/06,2022/05/06 17:30
9,Le Mans,32,12,9,11,32,30,16,8,4,4,18,12,16,4,5,7,14,18,45,2,1.94,0.9375,0.75,1.125,1,1.125,0.875,36.75958188,26.48083624,36.75958188,34,94.1,0.5,France-National,2022/05/06,2022/04/29 18:00
10,Orleans,32,11,11,10,34,32,16,6,6,4,19,13,16,5,5,6,15,19,44,2,2.06,1,0.8125,1.1875,1.0625,1.1875,0.9375,36.75958188,26.48083624,36.75958188,34,94.1,0.555555556,France-National,2022/05/06,2022/05/06 17:30
11,Red Star,31,12,5,14,48,44,15,6,2,7,23,21,16,6,3,7,25,23,41,4,2.97,1.419354839,1.4,1.4375,1.548387097,1.533333333,1.5625,36.75958188,26.48083624,36.75958188,34,91.2,0.611111111,France-National,2022/05/06,2022/05/06 17:30
12,Cholet,32,11,7,14,45,57,16,7,4,5,28,27,16,4,3,9,17,30,40,-12,3.19,1.78125,1.6875,1.875,1.40625,1.75,1.0625,36.75958188,26.48083624,36.75958188,34,94.1,0.666666667,France-National,2022/05/06,2022/04/29 18:00
12,Cholet,32,11,7,14,45,57,16,7,4,5,28,27,16,4,3,9,17,30,40,-12,3.19,1.78125,1.6875,1.875,1.40625,1.75,1.0625,36.75958188,26.48083624,36.75958188,34,94.1,0.666666667,France-National,2022/05/06,2022/05/06 17:30
13,Avranches,32,10,6,16,32,56,16,6,2,8,17,29,16,4,4,8,15,27,36,-24,2.75,1.75,1.8125,1.6875,1,1.0625,0.9375,36.75958188,26.48083624,36.75958188,34,94.1,0.722222222,France-National,2022/05/06,2022/04/29 18:00
13,Avranches,32,10,6,16,32,56,16,6,2,8,17,29,16,4,4,8,15,27,36,-24,2.75,1.75,1.8125,1.6875,1,1.0625,0.9375,36.75958188,26.48083624,36.75958188,34,94.1,0.722222222,France-National,2022/05/06,2022/05/06 17:30
14,Sete,31,8,7,16,30,40,16,5,6,5,18,15,15,3,1,11,12,25,31,-10,2.26,1.290322581,0.9375,1.666666667,0.967741935,1.125,0.8,36.75958188,26.48083624,36.75958188,34,91.2,0.777777778,France-National,2022/05/06,2022/05/06 17:30
14,Sete,31,8,7,16,30,40,16,5,6,5,18,15,15,3,1,11,12,25,31,-10,2.26,1.290322581,0.9375,1.666666667,0.967741935,1.125,0.8,36.75958188,26.48083624,36.75958188,34,91.2,0.777777778,France-National,2022/05/06,2022/04/29 18:00
15,Bastia Borgo,32,7,9,16,39,56,16,6,5,5,27,23,16,1,4,11,12,33,30,-17,2.97,1.75,1.4375,2.0625,1.21875,1.6875,0.75,36.75958188,26.48083624,36.75958188,34,94.1,0.833333333,France-National,2022/05/06,2022/04/29 18:00
15,Bastia Borgo,32,7,9,16,39,56,16,6,5,5,27,23,16,1,4,11,12,33,30,-17,2.97,1.75,1.4375,2.0625,1.21875,1.6875,0.75,36.75958188,26.48083624,36.75958188,34,94.1,0.833333333,France-National,2022/05/06,2022/05/06 17:30
16,Boulogne,32,6,9,17,28,44,16,3,7,6,14,20,16,3,2,11,14,24,27,-16,2.25,1.375,1.25,1.5,0.875,0.875,0.875,36.75958188,26.48083624,36.75958188,34,94.1,0.888888889,France-National,2022/05/06,2022/04/29 18:00
16,Boulogne,32,6,9,17,28,44,16,3,7,6,14,20,16,3,2,11,14,24,27,-16,2.25,1.375,1.25,1.5,0.875,0.875,0.875,36.75958188,26.48083624,36.75958188,34,94.1,0.888888889,France-National,2022/05/06,2022/05/06 17:30
17,Chambly,32,6,8,18,34,58,16,3,6,7,23,30,16,3,2,11,11,28,26,-24,2.88,1.8125,1.875,1.75,1.0625,1.4375,0.6875,36.75958188,26.48083624,36.75958188,34,94.1,0.944444444,France-National,2022/05/06,2022/05/02 17:45
17,Chambly,32,6,8,18,34,58,16,3,6,7,23,30,16,3,2,11,11,28,26,-24,2.88,1.8125,1.875,1.75,1.0625,1.4375,0.6875,36.75958188,26.48083624,36.75958188,34,94.1,0.944444444,France-National,2022/05/06,2022/05/06 17:30
18,Creteil,32,6,7,19,30,52,16,5,4,7,19,22,16,1,3,12,11,30,25,-22,2.56,1.625,1.375,1.875,0.9375,1.1875,0.6875,36.75958188,26.48083624,36.75958188,34,94.1,1,France-National,2022/05/06,2022/05/06 17:30
18,Creteil,32,6,7,19,30,52,16,5,4,7,19,22,16,1,3,12,11,30,25,-22,2.56,1.625,1.375,1.875,0.9375,1.1875,0.6875,36.75958188,26.48083624,36.75958188,34,94.1,1,France-National,2022/05/06,2022/04/29 18:00
1,Schalke 04,32,18,5,9,67,41,16,9,2,5,37,25,16,9,3,4,30,16,59,26,3.38,1.28125,1.5625,1,2.09375,2.3125,1.875,35.41666667,29.16666667,35.41666667,34,94.1,0.055555556,Germany-2-Bundesliga,2022/05/06,2022/05/07 19:30
2,Darmstadt,32,17,6,9,67,44,16,9,3,4,39,23,16,8,3,5,28,21,57,23,3.47,1.375,1.4375,1.3125,2.09375,2.4375,1.75,35.41666667,29.16666667,35.41666667,34,94.1,0.111111111,Germany-2-Bundesliga,2022/05/06,2022/04/30 19:30
2,Darmstadt,32,17,6,9,67,44,16,9,3,4,39,23,16,8,3,5,28,21,57,23,3.47,1.375,1.4375,1.3125,2.09375,2.4375,1.75,35.41666667,29.16666667,35.41666667,34,94.1,0.111111111,Germany-2-Bundesliga,2022/05/06,2022/05/06 17:30
3,Werder Brem,32,16,9,7,60,43,16,7,6,3,27,17,16,9,3,4,33,26,57,17,3.22,1.34375,1.0625,1.625,1.875,1.6875,2.0625,35.41666667,29.16666667,35.41666667,34,94.1,0.166666667,Germany-2-Bundesliga,2022/05/06,2022/05/08 12:30
4,Hamburger,32,14,12,6,62,32,16,8,6,2,34,16,16,6,6,4,28,16,54,30,2.94,1,1,1,1.9375,2.125,1.75,35.41666667,29.16666667,35.41666667,34,94.1,0.222222222,Germany-2-Bundesliga,2022/05/06,2022/05/07 12:30
4,Hamburger,32,14,12,6,62,32,16,8,6,2,34,16,16,6,6,4,28,16,54,30,2.94,1,1,1,1.9375,2.125,1.75,35.41666667,29.16666667,35.41666667,34,94.1,0.222222222,Germany-2-Bundesliga,2022/05/06,2022/04/30 12:30
5,St Pauli,32,15,9,8,57,43,16,10,4,2,35,17,16,5,5,6,22,26,54,14,3.12,1.34375,1.0625,1.625,1.78125,2.1875,1.375,35.41666667,29.16666667,35.41666667,34,94.1,0.277777778,Germany-2-Bundesliga,2022/05/06,2022/05/07 19:30
6,Nurnberg,32,14,9,9,48,44,16,8,3,5,25,21,16,6,6,4,23,23,51,4,2.88,1.375,1.3125,1.4375,1.5,1.5625,1.4375,35.41666667,29.16666667,35.41666667,34,94.1,0.333333333,Germany-2-Bundesliga,2022/05/06,2022/05/08 12:30
7,Paderborn,32,12,12,8,54,41,16,3,7,6,24,24,16,9,5,2,30,17,48,13,2.97,1.28125,1.5,1.0625,1.6875,1.5,1.875,35.41666667,29.16666667,35.41666667,34,94.1,0.388888889,Germany-2-Bundesliga,2022/05/06,2022/05/06 17:30
7,Paderborn,32,12,12,8,54,41,16,3,7,6,24,24,16,9,5,2,30,17,48,13,2.97,1.28125,1.5,1.0625,1.6875,1.5,1.875,35.41666667,29.16666667,35.41666667,34,94.1,0.388888889,Germany-2-Bundesliga,2022/05/06,2022/04/30 12:30
8,Heidenheim,32,13,7,12,39,45,16,9,4,3,25,18,16,4,3,9,14,27,46,-6,2.62,1.40625,1.125,1.6875,1.21875,1.5625,0.875,35.41666667,29.16666667,35.41666667,34,94.1,0.444444444,Germany-2-Bundesliga,2022/05/06,2022/04/29 17:30
8,Heidenheim,32,13,7,12,39,45,16,9,4,3,25,18,16,4,3,9,14,27,46,-6,2.62,1.40625,1.125,1.6875,1.21875,1.5625,0.875,35.41666667,29.16666667,35.41666667,34,94.1,0.444444444,Germany-2-Bundesliga,2022/05/06,2022/05/07 12:30
9,Holstein Kiel,32,11,9,12,42,51,16,7,3,6,20,23,16,4,6,6,22,28,42,-9,2.91,1.59375,1.4375,1.75,1.3125,1.25,1.375,35.41666667,29.16666667,35.41666667,34,94.1,0.5,Germany-2-Bundesliga,2022/05/06,2022/05/08 12:30
10,Dusseldorf,32,10,11,11,43,39,16,5,6,5,26,20,16,5,5,6,17,19,41,4,2.56,1.21875,1.25,1.1875,1.34375,1.625,1.0625,35.41666667,29.16666667,35.41666667,34,94.1,0.555555556,Germany-2-Bundesliga,2022/05/06,2022/05/06 17:30
10,Dusseldorf,32,10,11,11,43,39,16,5,6,5,26,20,16,5,5,6,17,19,41,4,2.56,1.21875,1.25,1.1875,1.34375,1.625,1.0625,35.41666667,29.16666667,35.41666667,34,94.1,0.555555556,Germany-2-Bundesliga,2022/05/06,2022/04/29 17:30
11,Regensburg,32,10,10,12,50,47,16,6,4,6,31,27,16,4,6,6,19,20,40,3,3.03,1.46875,1.6875,1.25,1.5625,1.9375,1.1875,35.41666667,29.16666667,35.41666667,34,94.1,0.611111111,Germany-2-Bundesliga,2022/05/06,2022/05/07 12:30
11,Regensburg,32,10,10,12,50,47,16,6,4,6,31,27,16,4,6,6,19,20,40,3,3.03,1.46875,1.6875,1.25,1.5625,1.9375,1.1875,35.41666667,29.16666667,35.41666667,34,94.1,0.611111111,Germany-2-Bundesliga,2022/05/06,2022/04/30 12:30
12,Karlsruher,32,9,13,10,52,51,16,5,8,3,30,24,16,4,5,7,22,27,40,1,3.22,1.59375,1.5,1.6875,1.625,1.875,1.375,35.41666667,29.16666667,35.41666667,34,94.1,0.666666667,Germany-2-Bundesliga,2022/05/06,2022/05/08 12:30
12,Karlsruher,32,9,13,10,52,51,16,5,8,3,30,24,16,4,5,7,22,27,40,1,3.22,1.59375,1.5,1.6875,1.625,1.875,1.375,35.41666667,29.16666667,35.41666667,34,94.1,0.666666667,Germany-2-Bundesliga,2022/05/06,2022/04/29 17:30
13,Han Rostock,32,10,10,12,39,49,16,4,5,7,15,22,16,6,5,5,24,27,40,-10,2.75,1.53125,1.375,1.6875,1.21875,0.9375,1.5,35.41666667,29.16666667,35.41666667,34,94.1,0.722222222,Germany-2-Bundesliga,2022/05/06,2022/04/30 12:30
13,Han Rostock,32,10,10,12,39,49,16,4,5,7,15,22,16,6,5,5,24,27,40,-10,2.75,1.53125,1.375,1.6875,1.21875,0.9375,1.5,35.41666667,29.16666667,35.41666667,34,94.1,0.722222222,Germany-2-Bundesliga,2022/05/06,2022/05/07 12:30
14,Hannover 96,32,10,9,13,31,45,16,5,6,5,13,17,16,5,3,8,18,28,39,-14,2.38,1.40625,1.0625,1.75,0.96875,0.8125,1.125,35.41666667,29.16666667,35.41666667,34,94.1,0.777777778,Germany-2-Bundesliga,2022/05/06,2022/04/29 17:30
14,Hannover 96,32,10,9,13,31,45,16,5,6,5,13,17,16,5,3,8,18,28,39,-14,2.38,1.40625,1.0625,1.75,0.96875,0.8125,1.125,35.41666667,29.16666667,35.41666667,34,94.1,0.777777778,Germany-2-Bundesliga,2022/05/06,2022/05/07 12:30
15,Sandhausen,32,9,11,12,39,51,16,3,5,8,16,28,16,6,6,4,23,23,38,-12,2.81,1.59375,1.75,1.4375,1.21875,1,1.4375,35.41666667,29.16666667,35.41666667,34,94.1,0.833333333,Germany-2-Bundesliga,2022/05/06,2022/05/06 17:30
16,Dresden,32,7,10,15,31,43,16,5,5,6,18,17,16,2,5,9,13,26,31,-12,2.31,1.34375,1.0625,1.625,0.96875,1.125,0.8125,35.41666667,29.16666667,35.41666667,34,94.1,0.888888889,Germany-2-Bundesliga,2022/05/06,2022/04/30 12:30
16,Dresden,32,7,10,15,31,43,16,5,5,6,18,17,16,2,5,9,13,26,31,-12,2.31,1.34375,1.0625,1.625,0.96875,1.125,0.8125,35.41666667,29.16666667,35.41666667,34,94.1,0.888888889,Germany-2-Bundesliga,2022/05/06,2022/05/08 12:30
17,Erzgebirge,32,5,8,19,31,69,16,3,3,10,14,31,16,2,5,9,17,38,23,-38,3.12,2.15625,1.9375,2.375,0.96875,0.875,1.0625,35.41666667,29.16666667,35.41666667,34,94.1,0.944444444,Germany-2-Bundesliga,2022/05/06,2022/05/08 12:30
17,Erzgebirge,32,5,8,19,31,69,16,3,3,10,14,31,16,2,5,9,17,38,23,-38,3.12,2.15625,1.9375,2.375,0.96875,0.875,1.0625,35.41666667,29.16666667,35.41666667,34,94.1,0.944444444,Germany-2-Bundesliga,2022/05/06,2022/04/30 19:30
18,Ingolstadt,32,4,8,20,28,62,16,2,4,10,12,29,16,2,4,10,16,33,20,-34,2.81,1.9375,1.8125,2.0625,0.875,0.75,1,35.41666667,29.16666667,35.41666667,34,94.1,1,Germany-2-Bundesliga,2022/05/06,2022/04/30 12:30
18,Ingolstadt,32,4,8,20,28,62,16,2,4,10,12,29,16,2,4,10,16,33,20,-34,2.81,1.9375,1.8125,2.0625,0.875,0.75,1,35.41666667,29.16666667,35.41666667,34,94.1,1,Germany-2-Bundesliga,2022/05/06,2022/05/07 12:30
1,Magdeburg,36,23,6,7,79,40,18,13,4,1,34,10,18,10,2,6,45,30,75,39,3.31,1.111111111,0.555555556,1.666666667,2.194444444,1.888888889,2.5,37.18309859,25.63380282,37.18309859,38,94.7,0.05,Germany-3-Liga,2022/05/06,2022/05/07 13:00
2,Braunschweig,35,19,10,6,61,32,18,9,6,3,29,20,17,10,4,3,32,12,67,29,2.66,0.914285714,1.111111111,0.705882353,1.742857143,1.611111111,1.882352941,37.18309859,25.63380282,37.18309859,38,92.1,0.1,Germany-3-Liga,2022/05/06,2022/05/07 13:00
3,Kaiserslautern,36,19,9,8,58,26,18,12,4,2,37,11,18,7,5,6,21,15,66,32,2.33,0.722222222,0.611111111,0.833333333,1.611111111,2.055555556,1.166666667,37.18309859,25.63380282,37.18309859,38,94.7,0.15,Germany-3-Liga,2022/05/06,2022/04/30 13:00
3,Kaiserslautern,36,19,9,8,58,26,18,12,4,2,37,11,18,7,5,6,21,15,66,32,2.33,0.722222222,0.611111111,0.833333333,1.611111111,2.055555556,1.166666667,37.18309859,25.63380282,37.18309859,38,94.7,0.15,Germany-3-Liga,2022/05/06,2022/05/08 13:00
4,Mannheim,36,16,12,8,53,39,18,8,5,5,29,21,18,8,7,3,24,18,60,14,2.56,1.083333333,1.166666667,1,1.472222222,1.611111111,1.333333333,37.18309859,25.63380282,37.18309859,38,94.7,0.2,Germany-3-Liga,2022/05/06,2022/05/02 18:00
4,Mannheim,36,16,12,8,53,39,18,8,5,5,29,21,18,8,7,3,24,18,60,14,2.56,1.083333333,1.166666667,1,1.472222222,1.611111111,1.333333333,37.18309859,25.63380282,37.18309859,38,94.7,0.2,Germany-3-Liga,2022/05/06,2022/05/07 13:00
5,1860 Munich,36,16,11,9,63,46,18,8,5,5,34,26,18,8,6,4,29,20,59,17,3.03,1.277777778,1.444444444,1.111111111,1.75,1.888888889,1.611111111,37.18309859,25.63380282,37.18309859,38,94.7,0.25,Germany-3-Liga,2022/05/06,2022/05/07 13:00
6,Osnabruck,36,16,11,9,58,44,18,8,4,6,22,15,18,8,7,3,36,29,59,14,2.83,1.222222222,0.833333333,1.611111111,1.611111111,1.222222222,2,37.18309859,25.63380282,37.18309859,38,94.7,0.3,Germany-3-Liga,2022/05/06,2022/04/30 13:00
6,Osnabruck,36,16,11,9,58,44,18,8,4,6,22,15,18,8,7,3,36,29,59,14,2.83,1.222222222,0.833333333,1.611111111,1.611111111,1.222222222,2,37.18309859,25.63380282,37.18309859,38,94.7,0.3,Germany-3-Liga,2022/05/06,2022/05/07 13:00
7,Saarbrucken,36,16,9,11,56,44,18,9,4,5,27,20,18,7,5,6,29,24,57,12,2.78,1.222222222,1.111111111,1.333333333,1.555555556,1.5,1.611111111,37.18309859,25.63380282,37.18309859,38,94.7,0.35,Germany-3-Liga,2022/05/06,2022/05/07 13:00
8,Wehen,36,15,7,14,48,43,18,7,5,6,20,18,18,8,2,8,28,25,52,5,2.53,1.194444444,1,1.388888889,1.333333333,1.111111111,1.555555556,37.18309859,25.63380282,37.18309859,38,94.7,0.4,Germany-3-Liga,2022/05/06,2022/05/07 13:00
9,Dortmund A,36,14,7,15,48,43,18,4,6,8,16,18,18,10,1,7,32,25,49,5,2.53,1.194444444,1,1.388888889,1.333333333,0.888888889,1.777777778,37.18309859,25.63380282,37.18309859,38,94.7,0.45,Germany-3-Liga,2022/05/06,2022/05/06 18:00
9,Dortmund A,36,14,7,15,48,43,18,4,6,8,16,18,18,10,1,7,32,25,49,5,2.53,1.194444444,1,1.388888889,1.333333333,0.888888889,1.777777778,37.18309859,25.63380282,37.18309859,38,94.7,0.45,Germany-3-Liga,2022/05/06,2022/04/30 13:00
10,Freiburg 2,36,13,10,13,37,45,18,9,5,4,27,19,18,4,5,9,10,26,49,-8,2.28,1.25,1.055555556,1.444444444,1.027777778,1.5,0.555555556,37.18309859,25.63380282,37.18309859,38,94.7,0.5,Germany-3-Liga,2022/05/06,2022/04/30 13:00
10,Freiburg 2,36,13,10,13,37,45,18,9,5,4,27,19,18,4,5,9,10,26,49,-8,2.28,1.25,1.055555556,1.444444444,1.027777778,1.5,0.555555556,37.18309859,25.63380282,37.18309859,38,94.7,0.5,Germany-3-Liga,2022/05/06,2022/05/07 13:00
11,Zwickau,35,10,14,11,40,45,17,5,6,6,20,24,18,5,8,5,20,21,44,-5,2.43,1.285714286,1.411764706,1.166666667,1.142857143,1.176470588,1.111111111,37.18309859,25.63380282,37.18309859,38,92.1,0.55,Germany-3-Liga,2022/05/06,2022/05/07 13:00
12,Meppen,35,12,8,15,41,55,18,7,4,7,27,24,17,5,4,8,14,31,44,-14,2.74,1.571428571,1.333333333,1.823529412,1.171428571,1.5,0.823529412,37.18309859,25.63380282,37.18309859,38,92.1,0.6,Germany-3-Liga,2022/05/06,2022/04/30 13:00
12,Meppen,35,12,8,15,41,55,18,7,4,7,27,24,17,5,4,8,14,31,44,-14,2.74,1.571428571,1.333333333,1.823529412,1.171428571,1.5,0.823529412,37.18309859,25.63380282,37.18309859,38,92.1,0.6,Germany-3-Liga,2022/05/06,2022/05/07 13:00
13,Hallescher,36,10,13,13,46,48,18,8,6,4,31,24,18,2,7,9,15,24,43,-2,2.61,1.333333333,1.333333333,1.333333333,1.277777778,1.722222222,0.833333333,37.18309859,25.63380282,37.18309859,38,94.7,0.65,Germany-3-Liga,2022/05/06,2022/04/30 13:00
13,Hallescher,36,10,13,13,46,48,18,8,6,4,31,24,18,2,7,9,15,24,43,-2,2.61,1.333333333,1.333333333,1.333333333,1.277777778,1.722222222,0.833333333,37.18309859,25.63380282,37.18309859,38,94.7,0.65,Germany-3-Liga,2022/05/06,2022/05/08 12:00
14,Viktor Koln,35,11,9,15,38,53,17,6,6,5,25,22,18,5,3,10,13,31,42,-15,2.6,1.514285714,1.294117647,1.722222222,1.085714286,1.470588235,0.722222222,37.18309859,25.63380282,37.18309859,38,92.1,0.7,Germany-3-Liga,2022/05/06,2022/05/08 13:00
14,Viktor Koln,35,11,9,15,38,53,17,6,6,5,25,22,18,5,3,10,13,31,42,-15,2.6,1.514285714,1.294117647,1.722222222,1.085714286,1.470588235,0.722222222,37.18309859,25.63380282,37.18309859,38,92.1,0.7,Germany-3-Liga,2022/05/06,2022/04/30 13:00
15,Duisburg,36,13,2,21,46,71,18,7,2,9,26,37,18,6,0,12,20,34,41,-25,3.25,1.972222222,2.055555556,1.888888889,1.277777778,1.444444444,1.111111111,37.18309859,25.63380282,37.18309859,38,94.7,0.75,Germany-3-Liga,2022/05/06,2022/05/07 13:00
15,Duisburg,36,13,2,21,46,71,18,7,2,9,26,37,18,6,0,12,20,34,41,-25,3.25,1.972222222,2.055555556,1.888888889,1.277777778,1.444444444,1.111111111,37.18309859,25.63380282,37.18309859,38,94.7,0.75,Germany-3-Liga,2022/05/06,2022/05/02 18:00
16,Verl,36,9,11,16,55,66,18,5,5,8,28,32,18,4,6,8,27,34,38,-11,3.36,1.833333333,1.777777778,1.888888889,1.527777778,1.555555556,1.5,37.18309859,25.63380282,37.18309859,38,94.7,0.8,Germany-3-Liga,2022/05/06,2022/05/06 18:00
17,Viktoria B,36,10,8,18,41,58,18,7,4,7,22,25,18,3,4,11,19,33,38,-17,2.75,1.611111111,1.388888889,1.833333333,1.138888889,1.222222222,1.055555556,37.18309859,25.63380282,37.18309859,38,94.7,0.85,Germany-3-Liga,2022/05/06,2022/05/07 13:00
18,Wurzburger Ks,35,8,9,18,35,51,18,3,5,10,19,31,17,5,4,8,16,20,33,-16,2.46,1.457142857,1.722222222,1.176470588,1,1.055555556,0.941176471,37.18309859,25.63380282,37.18309859,38,92.1,0.9,Germany-3-Liga,2022/05/06,2022/05/08 12:00
18,Wurzburger Ks,35,8,9,18,35,51,18,3,5,10,19,31,17,5,4,8,16,20,33,-16,2.46,1.457142857,1.722222222,1.176470588,1,1.055555556,0.941176471,37.18309859,25.63380282,37.18309859,38,92.1,0.9,Germany-3-Liga,2022/05/06,2022/04/30 13:00
19,Turk Ataspor,31,8,8,15,30,47,15,6,4,5,20,22,16,2,4,10,10,25,32,-17,2.48,1.516129032,1.466666667,1.5625,0.967741935,1.333333333,0.625,37.18309859,25.63380282,37.18309859,38,81.6,0.95,Germany-3-Liga,2022/05/06,2022/05/07 13:00
20,TSV Havelse,36,6,8,22,29,66,18,4,1,13,14,36,18,2,7,9,15,30,26,-37,2.64,1.833333333,2,1.666666667,0.805555556,0.777777778,0.833333333,37.18309859,25.63380282,37.18309859,38,94.7,1,Germany-3-Liga,2022/05/06,2022/05/07 13:00
1,Asante Kotok,27,16,7,4,39,16,14,10,2,2,27,10,13,6,5,2,12,6,55,23,2.04,0.592592593,0.714285714,0.461538462,1.444444444,1.928571429,0.923076923,36.21399177,27.57201646,36.21399177,34,79.4,0.055555556,Ghana-Premier,2022/05/06,2022/05/08 16:00
2,Bechem Utd,27,12,10,5,30,17,13,10,3,0,19,2,14,2,7,5,11,15,46,13,1.74,0.62962963,0.153846154,1.071428571,1.111111111,1.461538462,0.785714286,36.21399177,27.57201646,36.21399177,34,79.4,0.111111111,Ghana-Premier,2022/05/06,2022/05/07 16:00
2,Bechem Utd,27,12,10,5,30,17,13,10,3,0,19,2,14,2,7,5,11,15,46,13,1.74,0.62962963,0.153846154,1.071428571,1.111111111,1.461538462,0.785714286,36.21399177,27.57201646,36.21399177,34,79.4,0.111111111,Ghana-Premier,2022/05/06,2022/05/01 16:00
3,Hearts Oak,27,11,10,6,28,17,14,8,5,1,19,7,13,3,5,5,9,10,43,11,1.67,0.62962963,0.5,0.769230769,1.037037037,1.357142857,0.692307692,36.21399177,27.57201646,36.21399177,34,79.4,0.166666667,Ghana-Premier,2022/05/06,2022/05/01 16:00
3,Hearts Oak,27,11,10,6,28,17,14,8,5,1,19,7,13,3,5,5,9,10,43,11,1.67,0.62962963,0.5,0.769230769,1.037037037,1.357142857,0.692307692,36.21399177,27.57201646,36.21399177,34,79.4,0.166666667,Ghana-Premier,2022/05/06,2022/05/07 16:00
4,Medeama,27,12,7,8,19,18,14,10,3,1,14,4,13,2,4,7,5,14,43,1,1.37,0.666666667,0.285714286,1.076923077,0.703703704,1,0.384615385,36.21399177,27.57201646,36.21399177,34,79.4,0.222222222,Ghana-Premier,2022/05/06,2022/05/08 16:00
4,Medeama,27,12,7,8,19,18,14,10,3,1,14,4,13,2,4,7,5,14,43,1,1.37,0.666666667,0.285714286,1.076923077,0.703703704,1,0.384615385,36.21399177,27.57201646,36.21399177,34,79.4,0.222222222,Ghana-Premier,2022/05/06,2022/05/02 16:00
5,Aduana Stars,27,11,8,8,31,23,14,7,4,3,22,12,13,4,4,5,9,11,41,8,2,0.851851852,0.857142857,0.846153846,1.148148148,1.571428571,0.692307692,36.21399177,27.57201646,36.21399177,34,79.4,0.277777778,Ghana-Premier,2022/05/06,2022/05/02 16:00
5,Aduana Stars,27,11,8,8,31,23,14,7,4,3,22,12,13,4,4,5,9,11,41,8,2,0.851851852,0.857142857,0.846153846,1.148148148,1.571428571,0.692307692,36.21399177,27.57201646,36.21399177,34,79.4,0.277777778,Ghana-Premier,2022/05/06,2022/05/08 16:00
6,Karela,27,10,10,7,33,28,13,8,5,0,22,9,14,2,5,7,11,19,40,5,2.26,1.037037037,0.692307692,1.357142857,1.222222222,1.692307692,0.785714286,36.21399177,27.57201646,36.21399177,34,79.4,0.333333333,Ghana-Premier,2022/05/06,2022/05/01 16:00
6,Karela,27,10,10,7,33,28,13,8,5,0,22,9,14,2,5,7,11,19,40,5,2.26,1.037037037,0.692307692,1.357142857,1.222222222,1.692307692,0.785714286,36.21399177,27.57201646,36.21399177,34,79.4,0.333333333,Ghana-Premier,2022/05/06,2022/05/08 16:00
7,Great Olymp,27,10,10,7,27,24,13,8,4,1,21,11,14,2,6,6,6,13,40,3,1.89,0.888888889,0.846153846,0.928571429,1,1.615384615,0.428571429,36.21399177,27.57201646,36.21399177,34,79.4,0.388888889,Ghana-Premier,2022/05/06,2022/05/06 16:00
8,Legon Cities,27,10,9,8,30,21,14,7,3,4,18,10,13,3,6,4,12,11,39,9,1.89,0.777777778,0.714285714,0.846153846,1.111111111,1.285714286,0.923076923,36.21399177,27.57201646,36.21399177,34,79.4,0.444444444,Ghana-Premier,2022/05/06,2022/05/01 16:00
8,Legon Cities,27,10,9,8,30,21,14,7,3,4,18,10,13,3,6,4,12,11,39,9,1.89,0.777777778,0.714285714,0.846153846,1.111111111,1.285714286,0.923076923,36.21399177,27.57201646,36.21399177,34,79.4,0.444444444,Ghana-Premier,2022/05/06,2022/05/09 16:00
9,Berekum Chel,27,10,9,8,24,24,14,8,5,1,12,3,13,2,4,7,12,21,39,0,1.78,0.888888889,0.214285714,1.615384615,0.888888889,0.857142857,0.923076923,36.21399177,27.57201646,36.21399177,34,79.4,0.5,Ghana-Premier,2022/05/06,2022/05/01 16:00
9,Berekum Chel,27,10,9,8,24,24,14,8,5,1,12,3,13,2,4,7,12,21,39,0,1.78,0.888888889,0.214285714,1.615384615,0.888888889,0.857142857,0.923076923,36.21399177,27.57201646,36.21399177,34,79.4,0.5,Ghana-Premier,2022/05/06,2022/05/06 16:00
10,Ashanti,27,11,5,11,36,27,14,7,4,3,29,11,13,4,1,8,7,16,38,9,2.33,1,0.785714286,1.230769231,1.333333333,2.071428571,0.538461538,36.21399177,27.57201646,36.21399177,34,79.4,0.555555556,Ghana-Premier,2022/05/06,2022/05/01 16:00
10,Ashanti,27,11,5,11,36,27,14,7,4,3,29,11,13,4,1,8,7,16,38,9,2.33,1,0.785714286,1.230769231,1.333333333,2.071428571,0.538461538,36.21399177,27.57201646,36.21399177,34,79.4,0.555555556,Ghana-Premier,2022/05/06,2022/05/08 16:00
11,Bibiani GS,27,11,2,14,23,31,13,11,0,2,16,5,14,0,2,12,7,26,35,-8,2,1.148148148,0.384615385,1.857142857,0.851851852,1.230769231,0.5,36.21399177,27.57201646,36.21399177,34,79.4,0.611111111,Ghana-Premier,2022/05/06,2022/05/08 16:00
11,Bibiani GS,27,11,2,14,23,31,13,11,0,2,16,5,14,0,2,12,7,26,35,-8,2,1.148148148,0.384615385,1.857142857,0.851851852,1.230769231,0.5,36.21399177,27.57201646,36.21399177,34,79.4,0.611111111,Ghana-Premier,2022/05/06,2022/05/01 16:00
12,Accra Lions,27,9,6,12,18,33,13,7,4,2,10,7,14,2,2,10,8,26,33,-15,1.89,1.222222222,0.538461538,1.857142857,0.666666667,0.769230769,0.571428571,36.21399177,27.57201646,36.21399177,34,79.4,0.666666667,Ghana-Premier,2022/05/06,2022/05/09 16:00
13,Dreams,27,8,8,11,39,39,13,6,4,3,23,15,14,2,4,8,16,24,32,0,2.89,1.444444444,1.153846154,1.714285714,1.444444444,1.769230769,1.142857143,36.21399177,27.57201646,36.21399177,34,79.4,0.722222222,Ghana-Premier,2022/05/06,2022/05/08 16:00
13,Dreams,27,8,8,11,39,39,13,6,4,3,23,15,14,2,4,8,16,24,32,0,2.89,1.444444444,1.153846154,1.714285714,1.444444444,1.769230769,1.142857143,36.21399177,27.57201646,36.21399177,34,79.4,0.722222222,Ghana-Premier,2022/05/06,2022/05/01 16:00
14,Real Tamale,27,8,8,11,30,36,14,7,6,1,21,10,13,1,2,10,9,26,32,-6,2.44,1.333333333,0.714285714,2,1.111111111,1.5,0.692307692,36.21399177,27.57201646,36.21399177,34,79.4,0.777777778,Ghana-Premier,2022/05/06,2022/05/08 16:00
15,King Faisal,27,9,4,14,23,28,13,6,2,5,13,11,14,3,2,9,10,17,31,-5,1.89,1.037037037,0.846153846,1.214285714,0.851851852,1,0.714285714,36.21399177,27.57201646,36.21399177,34,79.4,0.833333333,Ghana-Premier,2022/05/06,2022/05/01 16:00
15,King Faisal,27,9,4,14,23,28,13,6,2,5,13,11,14,3,2,9,10,17,31,-5,1.89,1.037037037,0.846153846,1.214285714,0.851851852,1,0.714285714,36.21399177,27.57201646,36.21399177,34,79.4,0.833333333,Ghana-Premier,2022/05/06,2022/05/08 16:00
16,Eleven Wondr,27,7,8,12,23,33,13,6,6,1,15,7,14,1,2,11,8,26,29,-10,2.07,1.222222222,0.538461538,1.857142857,0.851851852,1.153846154,0.571428571,36.21399177,27.57201646,36.21399177,34,79.4,0.888888889,Ghana-Premier,2022/05/06,2022/05/08 16:00
17,WAFA,27,6,8,13,18,33,14,6,4,4,14,11,13,0,4,9,4,22,26,-15,1.89,1.222222222,0.785714286,1.692307692,0.666666667,1,0.307692308,36.21399177,27.57201646,36.21399177,34,79.4,0.944444444,Ghana-Premier,2022/05/06,2022/05/08 16:00
18,Elmina Shrks,27,5,5,17,18,41,13,5,3,5,14,15,14,0,2,12,4,26,20,-23,2.19,1.518518519,1.153846154,1.857142857,0.666666667,1.076923077,0.285714286,36.21399177,27.57201646,36.21399177,34,79.4,1,Ghana-Premier,2022/05/06,2022/05/08 16:00
18,Elmina Shrks,27,5,5,17,18,41,13,5,3,5,14,15,14,0,2,12,4,26,20,-23,2.19,1.518518519,1.153846154,1.857142857,0.666666667,1.076923077,0.285714286,36.21399177,27.57201646,36.21399177,34,79.4,1,Ghana-Premier,2022/05/06,2022/05/01 16:00
1,Breidablik,3,3,0,0,8,1,2,2,0,0,7,1,1,1,0,0,1,0,9,7,3,0.333333333,0.5,0,2.666666667,3.5,1,42.10526316,15.78947368,42.10526316,22,13.6,0.083333333,Iceland-Urvalsdeild,2022/05/06,2022/05/01 20:15
1,Breidablik,3,3,0,0,8,1,2,2,0,0,7,1,1,1,0,0,1,0,9,7,3,0.333333333,0.5,0,2.666666667,3.5,1,42.10526316,15.78947368,42.10526316,22,13.6,0.083333333,Iceland-Urvalsdeild,2022/05/06,2022/04/25 19:00
1,Breidablik,3,3,0,0,8,1,2,2,0,0,7,1,1,1,0,0,1,0,9,7,3,0.333333333,0.5,0,2.666666667,3.5,1,42.10526316,15.78947368,42.10526316,22,13.6,0.083333333,Iceland-Urvalsdeild,2022/05/06,2022/05/07 15:00
2,KA Akureyri,3,3,0,0,7,2,2,2,0,0,4,2,1,1,0,0,3,0,9,5,3,0.666666667,1,0,2.333333333,2,3,42.10526316,15.78947368,42.10526316,22,13.6,0.166666667,Iceland-Urvalsdeild,2022/05/06,2022/05/02 19:00
2,KA Akureyri,3,3,0,0,7,2,2,2,0,0,4,2,1,1,0,0,3,0,9,5,3,0.666666667,1,0,2.333333333,2,3,42.10526316,15.78947368,42.10526316,22,13.6,0.166666667,Iceland-Urvalsdeild,2022/05/06,2022/05/07 17:15
3,Valur,3,3,0,0,5,2,2,2,0,0,4,2,1,1,0,0,1,0,9,3,2.33,0.666666667,1,0,1.666666667,2,1,42.10526316,15.78947368,42.10526316,22,13.6,0.25,Iceland-Urvalsdeild,2022/05/06,2022/04/30 20:15
3,Valur,3,3,0,0,5,2,2,2,0,0,4,2,1,1,0,0,1,0,9,3,2.33,0.666666667,1,0,1.666666667,2,1,42.10526316,15.78947368,42.10526316,22,13.6,0.25,Iceland-Urvalsdeild,2022/05/06,2022/05/06 20:15
4,Stjarnan,3,2,1,0,10,6,1,0,1,0,2,2,2,2,0,0,8,4,7,4,5.33,2,2,2,3.333333333,2,4,42.10526316,15.78947368,42.10526316,22,13.6,0.333333333,Iceland-Urvalsdeild,2022/05/06,2022/05/07 17:15
4,Stjarnan,3,2,1,0,10,6,1,0,1,0,2,2,2,2,0,0,8,4,7,4,5.33,2,2,2,3.333333333,2,4,42.10526316,15.78947368,42.10526316,22,13.6,0.333333333,Iceland-Urvalsdeild,2022/05/06,2022/05/02 20:15
5,Vikingur,4,2,0,2,10,10,3,2,0,1,10,7,1,0,0,1,0,3,6,0,5,2.5,2.333333333,3,2.5,3.333333333,0,42.10526316,15.78947368,42.10526316,22,18.2,0.416666667,Iceland-Urvalsdeild,2022/05/06,2022/04/28 20:15
5,Vikingur,4,2,0,2,10,10,3,2,0,1,10,7,1,0,0,1,0,3,6,0,5,2.5,2.333333333,3,2.5,3.333333333,0,42.10526316,15.78947368,42.10526316,22,18.2,0.416666667,Iceland-Urvalsdeild,2022/05/06,2022/05/02 20:15
5,Vikingur,4,2,0,2,10,10,3,2,0,1,10,7,1,0,0,1,0,3,6,0,5,2.5,2.333333333,3,2.5,3.333333333,0,42.10526316,15.78947368,42.10526316,22,18.2,0.416666667,Iceland-Urvalsdeild,2022/05/06,2022/05/08 17:30
6,IA Akranes,3,1,2,0,6,3,1,1,0,0,3,0,2,0,2,0,3,3,5,3,3,1,0,1.5,2,3,1.5,42.10526316,15.78947368,42.10526316,22,13.6,0.5,Iceland-Urvalsdeild,2022/05/06,2022/05/07 15:00
6,IA Akranes,3,1,2,0,6,3,1,1,0,0,3,0,2,0,2,0,3,3,5,3,3,1,0,1.5,2,3,1.5,42.10526316,15.78947368,42.10526316,22,13.6,0.5,Iceland-Urvalsdeild,2022/05/06,2022/05/02 20:15
7,KR Reykjavik,3,1,0,2,5,4,1,0,0,1,0,1,2,1,0,1,5,3,3,1,3,1.333333333,1,1.5,1.666666667,0,2.5,42.10526316,15.78947368,42.10526316,22,13.6,0.583333333,Iceland-Urvalsdeild,2022/05/06,2022/04/25 19:00
7,KR Reykjavik,3,1,0,2,5,4,1,0,0,1,0,1,2,1,0,1,5,3,3,1,3,1.333333333,1,1.5,1.666666667,0,2.5,42.10526316,15.78947368,42.10526316,22,13.6,0.583333333,Iceland-Urvalsdeild,2022/05/06,2022/05/07 17:15
7,KR Reykjavik,3,1,0,2,5,4,1,0,0,1,0,1,2,1,0,1,5,3,3,1,3,1.333333333,1,1.5,1.666666667,0,2.5,42.10526316,15.78947368,42.10526316,22,13.6,0.583333333,Iceland-Urvalsdeild,2022/05/06,2022/04/30 20:15
8,FH Hafnarfj,3,1,0,2,5,7,1,1,0,0,4,2,2,0,0,2,1,5,3,-2,4,2.333333333,2,2.5,1.666666667,4,0.5,42.10526316,15.78947368,42.10526316,22,13.6,0.666666667,Iceland-Urvalsdeild,2022/05/06,2022/04/25 19:00
8,FH Hafnarfj,3,1,0,2,5,7,1,1,0,0,4,2,2,0,0,2,1,5,3,-2,4,2.333333333,2,2.5,1.666666667,4,0.5,42.10526316,15.78947368,42.10526316,22,13.6,0.666666667,Iceland-Urvalsdeild,2022/05/06,2022/05/06 20:15
8,FH Hafnarfj,3,1,0,2,5,7,1,1,0,0,4,2,2,0,0,2,1,5,3,-2,4,2.333333333,2,2.5,1.666666667,4,0.5,42.10526316,15.78947368,42.10526316,22,13.6,0.666666667,Iceland-Urvalsdeild,2022/05/06,2022/05/01 20:15
9,Leiknir R,3,0,1,2,1,5,1,0,0,1,0,3,2,0,1,1,1,2,1,-4,2,1.666666667,3,1,0.333333333,0,0.5,42.10526316,15.78947368,42.10526316,22,13.6,0.75,Iceland-Urvalsdeild,2022/05/06,2022/05/08 17:30
9,Leiknir R,3,0,1,2,1,5,1,0,0,1,0,3,2,0,1,1,1,2,1,-4,2,1.666666667,3,1,0.333333333,0,0.5,42.10526316,15.78947368,42.10526316,22,13.6,0.75,Iceland-Urvalsdeild,2022/05/06,2022/05/01 17:00
10,IBV Vestman.,3,0,1,2,2,6,2,0,1,1,1,4,1,0,0,1,1,2,1,-4,2.67,2,2,2,0.666666667,0.5,1,42.10526316,15.78947368,42.10526316,22,13.6,0.833333333,Iceland-Urvalsdeild,2022/05/06,2022/05/01 17:00
10,IBV Vestman.,3,0,1,2,2,6,2,0,1,1,1,4,1,0,0,1,1,2,1,-4,2.67,2,2,2,0.666666667,0.5,1,42.10526316,15.78947368,42.10526316,22,13.6,0.833333333,Iceland-Urvalsdeild,2022/05/06,2022/05/07 17:00
11,Fram,3,0,1,2,4,9,2,0,1,1,2,5,1,0,0,1,2,4,1,-5,4.33,3,2.5,4,1.333333333,1,2,42.10526316,15.78947368,42.10526316,22,13.6,0.916666667,Iceland-Urvalsdeild,2022/05/06,2022/05/02 20:15
11,Fram,3,0,1,2,4,9,2,0,1,1,2,5,1,0,0,1,2,4,1,-5,4.33,3,2.5,4,1.333333333,1,2,42.10526316,15.78947368,42.10526316,22,13.6,0.916666667,Iceland-Urvalsdeild,2022/05/06,2022/04/25 19:00
11,Fram,3,0,1,2,4,9,2,0,1,1,2,5,1,0,0,1,2,4,1,-5,4.33,3,2.5,4,1.333333333,1,2,42.10526316,15.78947368,42.10526316,22,13.6,0.916666667,Iceland-Urvalsdeild,2022/05/06,2022/05/07 17:15
12,Keflavik,4,0,0,4,4,12,1,0,0,1,0,1,3,0,0,3,4,11,0,-8,4,3,1,3.666666667,1,0,1.333333333,42.10526316,15.78947368,42.10526316,22,18.2,1,Iceland-Urvalsdeild,2022/05/06,2022/05/07 17:00
12,Keflavik,4,0,0,4,4,12,1,0,0,1,0,1,3,0,0,3,4,11,0,-8,4,3,1,3.666666667,1,0,1.333333333,42.10526316,15.78947368,42.10526316,22,18.2,1,Iceland-Urvalsdeild,2022/05/06,2022/04/28 20:15
12,Keflavik,4,0,0,4,4,12,1,0,0,1,0,1,3,0,0,3,4,11,0,-8,4,3,1,3.666666667,1,0,1.333333333,42.10526316,15.78947368,42.10526316,22,18.2,1,Iceland-Urvalsdeild,2022/05/06,2022/05/02 19:00
1,Cork City,13,10,2,1,31,6,7,5,1,1,15,3,6,5,1,0,16,3,32,25,2.85,0.461538462,0.428571429,0.5,2.384615385,2.142857143,2.666666667,38.18181818,23.63636364,38.18181818,16,81.2,0.111111111,Ireland-First-Division,2022/05/06,2022/04/29 19:45
1,Cork City,13,10,2,1,31,6,7,5,1,1,15,3,6,5,1,0,16,3,32,25,2.85,0.461538462,0.428571429,0.5,2.384615385,2.142857143,2.666666667,38.18181818,23.63636364,38.18181818,16,81.2,0.111111111,Ireland-First-Division,2022/05/06,2022/05/02 17:00
1,Cork City,13,10,2,1,31,6,7,5,1,1,15,3,6,5,1,0,16,3,32,25,2.85,0.461538462,0.428571429,0.5,2.384615385,2.142857143,2.666666667,38.18181818,23.63636364,38.18181818,16,81.2,0.111111111,Ireland-First-Division,2022/05/06,2022/04/22 19:45
1,Cork City,13,10,2,1,31,6,7,5,1,1,15,3,6,5,1,0,16,3,32,25,2.85,0.461538462,0.428571429,0.5,2.384615385,2.142857143,2.666666667,38.18181818,23.63636364,38.18181818,16,81.2,0.111111111,Ireland-First-Division,2022/05/06,2022/05/06 19:45
2,Galway Utd,12,9,2,1,21,10,6,4,2,0,10,4,6,5,0,1,11,6,29,11,2.58,0.833333333,0.666666667,1,1.75,1.666666667,1.833333333,38.18181818,23.63636364,38.18181818,16,75,0.222222222,Ireland-First-Division,2022/05/06,2022/04/22 19:45
2,Galway Utd,12,9,2,1,21,10,6,4,2,0,10,4,6,5,0,1,11,6,29,11,2.58,0.833333333,0.666666667,1,1.75,1.666666667,1.833333333,38.18181818,23.63636364,38.18181818,16,75,0.222222222,Ireland-First-Division,2022/05/06,2022/05/02 17:00
2,Galway Utd,12,9,2,1,21,10,6,4,2,0,10,4,6,5,0,1,11,6,29,11,2.58,0.833333333,0.666666667,1,1.75,1.666666667,1.833333333,38.18181818,23.63636364,38.18181818,16,75,0.222222222,Ireland-First-Division,2022/05/06,2022/04/29 19:45
2,Galway Utd,12,9,2,1,21,10,6,4,2,0,10,4,6,5,0,1,11,6,29,11,2.58,0.833333333,0.666666667,1,1.75,1.666666667,1.833333333,38.18181818,23.63636364,38.18181818,16,75,0.222222222,Ireland-First-Division,2022/05/06,2022/05/06 19:45
3,Waterford U,12,6,2,4,20,13,6,3,1,2,6,5,6,3,1,2,14,8,20,7,2.75,1.083333333,0.833333333,1.333333333,1.666666667,1,2.333333333,38.18181818,23.63636364,38.18181818,16,75,0.333333333,Ireland-First-Division,2022/05/06,2022/05/02 14:00
3,Waterford U,12,6,2,4,20,13,6,3,1,2,6,5,6,3,1,2,14,8,20,7,2.75,1.083333333,0.833333333,1.333333333,1.666666667,1,2.333333333,38.18181818,23.63636364,38.18181818,16,75,0.333333333,Ireland-First-Division,2022/05/06,2022/05/06 19:45
4,Longford Tn,11,5,3,3,14,11,6,3,2,1,7,3,5,2,1,2,7,8,18,3,2.27,1,0.5,1.6,1.272727273,1.166666667,1.4,38.18181818,23.63636364,38.18181818,16,68.8,0.444444444,Ireland-First-Division,2022/05/06,2022/04/23 19:30
4,Longford Tn,11,5,3,3,14,11,6,3,2,1,7,3,5,2,1,2,7,8,18,3,2.27,1,0.5,1.6,1.272727273,1.166666667,1.4,38.18181818,23.63636364,38.18181818,16,68.8,0.444444444,Ireland-First-Division,2022/05/06,2022/05/07 19:30
4,Longford Tn,11,5,3,3,14,11,6,3,2,1,7,3,5,2,1,2,7,8,18,3,2.27,1,0.5,1.6,1.272727273,1.166666667,1.4,38.18181818,23.63636364,38.18181818,16,68.8,0.444444444,Ireland-First-Division,2022/05/06,2022/04/29 19:45
4,Longford Tn,11,5,3,3,14,11,6,3,2,1,7,3,5,2,1,2,7,8,18,3,2.27,1,0.5,1.6,1.272727273,1.166666667,1.4,38.18181818,23.63636364,38.18181818,16,68.8,0.444444444,Ireland-First-Division,2022/05/06,2022/05/02 17:00
5,Treaty Utd,12,4,4,4,15,16,5,3,0,2,8,9,7,1,4,2,7,7,16,-1,2.58,1.333333333,1.8,1,1.25,1.6,1,38.18181818,23.63636364,38.18181818,16,75,0.555555556,Ireland-First-Division,2022/05/06,2022/04/29 19:45
5,Treaty Utd,12,4,4,4,15,16,5,3,0,2,8,9,7,1,4,2,7,7,16,-1,2.58,1.333333333,1.8,1,1.25,1.6,1,38.18181818,23.63636364,38.18181818,16,75,0.555555556,Ireland-First-Division,2022/05/06,2022/04/23 19:30
5,Treaty Utd,12,4,4,4,15,16,5,3,0,2,8,9,7,1,4,2,7,7,16,-1,2.58,1.333333333,1.8,1,1.25,1.6,1,38.18181818,23.63636364,38.18181818,16,75,0.555555556,Ireland-First-Division,2022/05/06,2022/05/02 17:00
6,Wexford Ys,13,4,3,6,17,22,7,2,1,4,8,15,6,2,2,2,9,7,15,-5,3,1.692307692,2.142857143,1.166666667,1.307692308,1.142857143,1.5,38.18181818,23.63636364,38.18181818,16,81.2,0.666666667,Ireland-First-Division,2022/05/06,2022/05/02 15:00
6,Wexford Ys,13,4,3,6,17,22,7,2,1,4,8,15,6,2,2,2,9,7,15,-5,3,1.692307692,2.142857143,1.166666667,1.307692308,1.142857143,1.5,38.18181818,23.63636364,38.18181818,16,81.2,0.666666667,Ireland-First-Division,2022/05/06,2022/04/29 19:45
6,Wexford Ys,13,4,3,6,17,22,7,2,1,4,8,15,6,2,2,2,9,7,15,-5,3,1.692307692,2.142857143,1.166666667,1.307692308,1.142857143,1.5,38.18181818,23.63636364,38.18181818,16,81.2,0.666666667,Ireland-First-Division,2022/05/06,2022/05/07 19:30
7,Bray Wanders,13,2,6,5,8,18,6,0,3,3,3,12,7,2,3,2,5,6,12,-10,2,1.384615385,2,0.857142857,0.615384615,0.5,0.714285714,38.18181818,23.63636364,38.18181818,16,81.2,0.777777778,Ireland-First-Division,2022/05/06,2022/04/29 19:45
7,Bray Wanders,13,2,6,5,8,18,6,0,3,3,3,12,7,2,3,2,5,6,12,-10,2,1.384615385,2,0.857142857,0.615384615,0.5,0.714285714,38.18181818,23.63636364,38.18181818,16,81.2,0.777777778,Ireland-First-Division,2022/05/06,2022/05/06 19:45
7,Bray Wanders,13,2,6,5,8,18,6,0,3,3,3,12,7,2,3,2,5,6,12,-10,2,1.384615385,2,0.857142857,0.615384615,0.5,0.714285714,38.18181818,23.63636364,38.18181818,16,81.2,0.777777778,Ireland-First-Division,2022/05/06,2022/04/22 19:45
7,Bray Wanders,13,2,6,5,8,18,6,0,3,3,3,12,7,2,3,2,5,6,12,-10,2,1.384615385,2,0.857142857,0.615384615,0.5,0.714285714,38.18181818,23.63636364,38.18181818,16,81.2,0.777777778,Ireland-First-Division,2022/05/06,2022/05/02 15:00
8,Cobh Ramblers,12,2,2,8,13,25,6,1,1,4,7,13,6,1,1,4,6,12,8,-12,3.17,2.083333333,2.166666667,2,1.083333333,1.166666667,1,38.18181818,23.63636364,38.18181818,16,75,0.888888889,Ireland-First-Division,2022/05/06,2022/04/22 19:45
8,Cobh Ramblers,12,2,2,8,13,25,6,1,1,4,7,13,6,1,1,4,6,12,8,-12,3.17,2.083333333,2.166666667,2,1.083333333,1.166666667,1,38.18181818,23.63636364,38.18181818,16,75,0.888888889,Ireland-First-Division,2022/05/06,2022/05/06 19:45
8,Cobh Ramblers,12,2,2,8,13,25,6,1,1,4,7,13,6,1,1,4,6,12,8,-12,3.17,2.083333333,2.166666667,2,1.083333333,1.166666667,1,38.18181818,23.63636364,38.18181818,16,75,0.888888889,Ireland-First-Division,2022/05/06,2022/04/29 19:45
9,Athlone Town,12,0,2,10,11,29,6,0,2,4,7,15,6,0,0,6,4,14,2,-18,3.33,2.416666667,2.5,2.333333333,0.916666667,1.166666667,0.666666667,38.18181818,23.63636364,38.18181818,16,75,1,Ireland-First-Division,2022/05/06,2022/04/29 19:45
9,Athlone Town,12,0,2,10,11,29,6,0,2,4,7,15,6,0,0,6,4,14,2,-18,3.33,2.416666667,2.5,2.333333333,0.916666667,1.166666667,0.666666667,38.18181818,23.63636364,38.18181818,16,75,1,Ireland-First-Division,2022/05/06,2022/05/06 19:45
9,Athlone Town,12,0,2,10,11,29,6,0,2,4,7,15,6,0,0,6,4,14,2,-18,3.33,2.416666667,2.5,2.333333333,0.916666667,1.166666667,0.666666667,38.18181818,23.63636364,38.18181818,16,75,1,Ireland-First-Division,2022/05/06,2022/05/02 14:00
1,Derry City,13,9,3,1,28,10,6,4,1,1,14,5,7,5,2,0,14,5,30,18,2.92,0.769230769,0.833333333,0.714285714,2.153846154,2.333333333,2,34.61538462,30.76923077,34.61538462,18,72.2,0.1,Ireland-Premier,2022/05/06,2022/04/22 19:45
1,Derry City,13,9,3,1,28,10,6,4,1,1,14,5,7,5,2,0,14,5,30,18,2.92,0.769230769,0.833333333,0.714285714,2.153846154,2.333333333,2,34.61538462,30.76923077,34.61538462,18,72.2,0.1,Ireland-Premier,2022/05/06,2022/05/06 19:45
1,Derry City,13,9,3,1,28,10,6,4,1,1,14,5,7,5,2,0,14,5,30,18,2.92,0.769230769,0.833333333,0.714285714,2.153846154,2.333333333,2,34.61538462,30.76923077,34.61538462,18,72.2,0.1,Ireland-Premier,2022/05/06,2022/05/09 19:45
1,Derry City,13,9,3,1,28,10,6,4,1,1,14,5,7,5,2,0,14,5,30,18,2.92,0.769230769,0.833333333,0.714285714,2.153846154,2.333333333,2,34.61538462,30.76923077,34.61538462,18,72.2,0.1,Ireland-Premier,2022/05/06,2022/04/29 19:45
2,Shamrock Rvs,13,8,3,2,21,9,6,5,1,0,11,3,7,3,2,2,10,6,27,12,2.31,0.692307692,0.5,0.857142857,1.615384615,1.833333333,1.428571429,34.61538462,30.76923077,34.61538462,18,72.2,0.2,Ireland-Premier,2022/05/06,2022/05/06 20:00
2,Shamrock Rvs,13,8,3,2,21,9,6,5,1,0,11,3,7,3,2,2,10,6,27,12,2.31,0.692307692,0.5,0.857142857,1.615384615,1.833333333,1.428571429,34.61538462,30.76923077,34.61538462,18,72.2,0.2,Ireland-Premier,2022/05/06,2022/05/09 20:00
2,Shamrock Rvs,13,8,3,2,21,9,6,5,1,0,11,3,7,3,2,2,10,6,27,12,2.31,0.692307692,0.5,0.857142857,1.615384615,1.833333333,1.428571429,34.61538462,30.76923077,34.61538462,18,72.2,0.2,Ireland-Premier,2022/05/06,2022/04/22 19:45
2,Shamrock Rvs,13,8,3,2,21,9,6,5,1,0,11,3,7,3,2,2,10,6,27,12,2.31,0.692307692,0.5,0.857142857,1.615384615,1.833333333,1.428571429,34.61538462,30.76923077,34.61538462,18,72.2,0.2,Ireland-Premier,2022/05/06,2022/04/29 19:45
3,Dundalk,13,5,6,2,18,10,7,5,2,0,15,5,6,0,4,2,3,5,21,8,2.15,0.769230769,0.714285714,0.833333333,1.384615385,2.142857143,0.5,34.61538462,30.76923077,34.61538462,18,72.2,0.3,Ireland-Premier,2022/05/06,2022/04/29 19:45
3,Dundalk,13,5,6,2,18,10,7,5,2,0,15,5,6,0,4,2,3,5,21,8,2.15,0.769230769,0.714285714,0.833333333,1.384615385,2.142857143,0.5,34.61538462,30.76923077,34.61538462,18,72.2,0.3,Ireland-Premier,2022/05/06,2022/05/06 19:45
4,Sligo Rovers,13,5,5,3,18,13,7,2,3,2,9,8,6,3,2,1,9,5,20,5,2.38,1,1.142857143,0.833333333,1.384615385,1.285714286,1.5,34.61538462,30.76923077,34.61538462,18,72.2,0.4,Ireland-Premier,2022/05/06,2022/04/23 19:45
4,Sligo Rovers,13,5,5,3,18,13,7,2,3,2,9,8,6,3,2,1,9,5,20,5,2.38,1,1.142857143,0.833333333,1.384615385,1.285714286,1.5,34.61538462,30.76923077,34.61538462,18,72.2,0.4,Ireland-Premier,2022/05/06,2022/04/29 19:45
4,Sligo Rovers,13,5,5,3,18,13,7,2,3,2,9,8,6,3,2,1,9,5,20,5,2.38,1,1.142857143,0.833333333,1.384615385,1.285714286,1.5,34.61538462,30.76923077,34.61538462,18,72.2,0.4,Ireland-Premier,2022/05/06,2022/05/06 19:45
4,Sligo Rovers,13,5,5,3,18,13,7,2,3,2,9,8,6,3,2,1,9,5,20,5,2.38,1,1.142857143,0.833333333,1.384615385,1.285714286,1.5,34.61538462,30.76923077,34.61538462,18,72.2,0.4,Ireland-Premier,2022/05/06,2022/05/09 20:00
5,St Patricks,13,6,2,5,15,12,7,3,2,2,7,7,6,3,0,3,8,5,20,3,2.08,0.923076923,1,0.833333333,1.153846154,1,1.333333333,34.61538462,30.76923077,34.61538462,18,72.2,0.5,Ireland-Premier,2022/05/06,2022/04/29 19:45
5,St Patricks,13,6,2,5,15,12,7,3,2,2,7,7,6,3,0,3,8,5,20,3,2.08,0.923076923,1,0.833333333,1.153846154,1,1.333333333,34.61538462,30.76923077,34.61538462,18,72.2,0.5,Ireland-Premier,2022/05/06,2022/05/06 19:45
5,St Patricks,13,6,2,5,15,12,7,3,2,2,7,7,6,3,0,3,8,5,20,3,2.08,0.923076923,1,0.833333333,1.153846154,1,1.333333333,34.61538462,30.76923077,34.61538462,18,72.2,0.5,Ireland-Premier,2022/05/06,2022/05/09 19:45
6,Bohemians,13,4,6,3,19,15,7,2,3,2,11,10,6,2,3,1,8,5,18,4,2.62,1.153846154,1.428571429,0.833333333,1.461538462,1.571428571,1.333333333,34.61538462,30.76923077,34.61538462,18,72.2,0.6,Ireland-Premier,2022/05/06,2022/04/22 19:45
6,Bohemians,13,4,6,3,19,15,7,2,3,2,11,10,6,2,3,1,8,5,18,4,2.62,1.153846154,1.428571429,0.833333333,1.461538462,1.571428571,1.333333333,34.61538462,30.76923077,34.61538462,18,72.2,0.6,Ireland-Premier,2022/05/06,2022/04/29 19:45
6,Bohemians,13,4,6,3,19,15,7,2,3,2,11,10,6,2,3,1,8,5,18,4,2.62,1.153846154,1.428571429,0.833333333,1.461538462,1.571428571,1.333333333,34.61538462,30.76923077,34.61538462,18,72.2,0.6,Ireland-Premier,2022/05/06,2022/05/06 19:45
7,Drogheda Utd,13,3,4,6,16,24,6,2,2,2,7,9,7,1,2,4,9,15,13,-8,3.08,1.846153846,1.5,2.142857143,1.230769231,1.166666667,1.285714286,34.61538462,30.76923077,34.61538462,18,72.2,0.7,Ireland-Premier,2022/05/06,2022/05/06 19:45
7,Drogheda Utd,13,3,4,6,16,24,6,2,2,2,7,9,7,1,2,4,9,15,13,-8,3.08,1.846153846,1.5,2.142857143,1.230769231,1.166666667,1.285714286,34.61538462,30.76923077,34.61538462,18,72.2,0.7,Ireland-Premier,2022/05/06,2022/04/23 19:45
7,Drogheda Utd,13,3,4,6,16,24,6,2,2,2,7,9,7,1,2,4,9,15,13,-8,3.08,1.846153846,1.5,2.142857143,1.230769231,1.166666667,1.285714286,34.61538462,30.76923077,34.61538462,18,72.2,0.7,Ireland-Premier,2022/05/06,2022/04/29 19:45
8,Shelbourne,13,3,3,7,10,19,6,0,1,5,3,14,7,3,2,2,7,5,12,-9,2.23,1.461538462,2.333333333,0.714285714,0.769230769,0.5,1,34.61538462,30.76923077,34.61538462,18,72.2,0.8,Ireland-Premier,2022/05/06,2022/05/06 19:45
8,Shelbourne,13,3,3,7,10,19,6,0,1,5,3,14,7,3,2,2,7,5,12,-9,2.23,1.461538462,2.333333333,0.714285714,0.769230769,0.5,1,34.61538462,30.76923077,34.61538462,18,72.2,0.8,Ireland-Premier,2022/05/06,2022/04/29 20:00
9,Finn Harps,13,2,4,7,11,21,7,1,2,4,5,11,6,1,2,3,6,10,10,-10,2.46,1.615384615,1.571428571,1.666666667,0.846153846,0.714285714,1,34.61538462,30.76923077,34.61538462,18,72.2,0.9,Ireland-Premier,2022/05/06,2022/04/29 20:00
9,Finn Harps,13,2,4,7,11,21,7,1,2,4,5,11,6,1,2,3,6,10,10,-10,2.46,1.615384615,1.571428571,1.666666667,0.846153846,0.714285714,1,34.61538462,30.76923077,34.61538462,18,72.2,0.9,Ireland-Premier,2022/05/06,2022/05/06 20:00
10,UCD,13,0,4,9,7,30,6,0,3,3,2,7,7,0,1,6,5,23,4,-23,2.85,2.307692308,1.166666667,3.285714286,0.538461538,0.333333333,0.714285714,34.61538462,30.76923077,34.61538462,18,72.2,1,Ireland-Premier,2022/05/06,2022/05/06 19:45
10,UCD,13,0,4,9,7,30,6,0,3,3,2,7,7,0,1,6,5,23,4,-23,2.85,2.307692308,1.166666667,3.285714286,0.538461538,0.333333333,0.714285714,34.61538462,30.76923077,34.61538462,18,72.2,1,Ireland-Premier,2022/05/06,2022/04/22 19:45
10,UCD,13,0,4,9,7,30,6,0,3,3,2,7,7,0,1,6,5,23,4,-23,2.85,2.307692308,1.166666667,3.285714286,0.538461538,0.333333333,0.714285714,34.61538462,30.76923077,34.61538462,18,72.2,1,Ireland-Premier,2022/05/06,2022/04/29 19:45
1,Lecce,37,18,14,5,58,31,18,12,5,1,36,14,19,6,9,4,22,17,68,27,2.41,0.837837838,0.777777778,0.894736842,1.567567568,2,1.157894737,34.18918919,31.62162162,34.18918919,38,97.4,0.05,Italy-Serie-B,2022/05/06,2022/05/06 19:30
1,Lecce,37,18,14,5,58,31,18,12,5,1,36,14,19,6,9,4,22,17,68,27,2.41,0.837837838,0.777777778,0.894736842,1.567567568,2,1.157894737,34.18918919,31.62162162,34.18918919,38,97.4,0.05,Italy-Serie-B,2022/05/06,2022/04/30 13:00
2,Monza,37,19,10,8,60,37,19,13,4,2,37,14,18,6,6,6,23,23,67,23,2.62,1,0.736842105,1.277777778,1.621621622,1.947368421,1.277777778,34.18918919,31.62162162,34.18918919,38,97.4,0.1,Italy-Serie-B,2022/05/06,2022/04/30 13:00
2,Monza,37,19,10,8,60,37,19,13,4,2,37,14,18,6,6,6,23,23,67,23,2.62,1,0.736842105,1.277777778,1.621621622,1.947368421,1.277777778,34.18918919,31.62162162,34.18918919,38,97.4,0.1,Italy-Serie-B,2022/05/06,2022/05/06 19:30
3,Cremonese,37,19,9,9,55,38,19,11,6,2,32,18,18,8,3,7,23,20,66,17,2.51,1.027027027,0.947368421,1.111111111,1.486486486,1.684210526,1.277777778,34.18918919,31.62162162,34.18918919,38,97.4,0.15,Italy-Serie-B,2022/05/06,2022/04/30 13:00
3,Cremonese,37,19,9,9,55,38,19,11,6,2,32,18,18,8,3,7,23,20,66,17,2.51,1.027027027,0.947368421,1.111111111,1.486486486,1.684210526,1.277777778,34.18918919,31.62162162,34.18918919,38,97.4,0.15,Italy-Serie-B,2022/05/06,2022/05/06 19:30
4,Pisa,37,17,13,7,46,34,19,10,8,1,26,13,18,7,5,6,20,21,64,12,2.16,0.918918919,0.684210526,1.166666667,1.243243243,1.368421053,1.111111111,34.18918919,31.62162162,34.18918919,38,97.4,0.2,Italy-Serie-B,2022/05/06,2022/05/06 19:30
5,Benevento,37,18,9,10,61,37,18,10,4,4,37,18,19,8,5,6,24,19,63,24,2.65,1,1,1,1.648648649,2.055555556,1.263157895,34.18918919,31.62162162,34.18918919,38,97.4,0.25,Italy-Serie-B,2022/05/06,2022/05/06 19:30
5,Benevento,37,18,9,10,61,37,18,10,4,4,37,18,19,8,5,6,24,19,63,24,2.65,1,1,1,1.648648649,2.055555556,1.263157895,34.18918919,31.62162162,34.18918919,38,97.4,0.25,Italy-Serie-B,2022/05/06,2022/04/30 13:00
6,Brescia,37,16,15,6,52,35,18,7,8,3,27,20,19,9,7,3,25,15,63,17,2.35,0.945945946,1.111111111,0.789473684,1.405405405,1.5,1.315789474,34.18918919,31.62162162,34.18918919,38,97.4,0.3,Italy-Serie-B,2022/05/06,2022/05/06 19:30
6,Brescia,37,16,15,6,52,35,18,7,8,3,27,20,19,9,7,3,25,15,63,17,2.35,0.945945946,1.111111111,0.789473684,1.405405405,1.5,1.315789474,34.18918919,31.62162162,34.18918919,38,97.4,0.3,Italy-Serie-B,2022/05/06,2022/04/30 13:00
7,Ascoli,37,18,8,11,48,41,18,7,6,5,20,17,19,11,2,6,28,24,62,7,2.41,1.108108108,0.944444444,1.263157895,1.297297297,1.111111111,1.473684211,34.18918919,31.62162162,34.18918919,38,97.4,0.35,Italy-Serie-B,2022/05/06,2022/05/06 19:30
7,Ascoli,37,18,8,11,48,41,18,7,6,5,20,17,19,11,2,6,28,24,62,7,2.41,1.108108108,0.944444444,1.263157895,1.297297297,1.111111111,1.473684211,34.18918919,31.62162162,34.18918919,38,97.4,0.35,Italy-Serie-B,2022/05/06,2022/04/30 13:00
8,Frosinone,37,15,13,9,57,43,18,10,6,2,33,14,19,5,7,7,24,29,58,14,2.7,1.162162162,0.777777778,1.526315789,1.540540541,1.833333333,1.263157895,34.18918919,31.62162162,34.18918919,38,97.4,0.4,Italy-Serie-B,2022/05/06,2022/05/06 19:30
9,Perugia,37,13,16,8,39,32,18,5,8,5,18,16,19,8,8,3,21,16,55,7,1.92,0.864864865,0.888888889,0.842105263,1.054054054,1,1.105263158,34.18918919,31.62162162,34.18918919,38,97.4,0.45,Italy-Serie-B,2022/05/06,2022/05/06 19:30
10,Ternana,37,15,9,13,57,57,19,9,2,8,30,27,18,6,7,5,27,30,54,0,3.08,1.540540541,1.421052632,1.666666667,1.540540541,1.578947368,1.5,34.18918919,31.62162162,34.18918919,38,97.4,0.5,Italy-Serie-B,2022/05/06,2022/05/06 19:30
11,Cittadella,37,13,13,11,38,35,19,7,5,7,22,18,18,6,8,4,16,17,52,3,1.97,0.945945946,0.947368421,0.944444444,1.027027027,1.157894737,0.888888889,34.18918919,31.62162162,34.18918919,38,97.4,0.55,Italy-Serie-B,2022/05/06,2022/04/30 13:00
11,Cittadella,37,13,13,11,38,35,19,7,5,7,22,18,18,6,8,4,16,17,52,3,1.97,0.945945946,0.947368421,0.944444444,1.027027027,1.157894737,0.888888889,34.18918919,31.62162162,34.18918919,38,97.4,0.55,Italy-Serie-B,2022/05/06,2022/05/06 19:30
12,Reggina 1914,37,13,9,15,31,46,19,9,2,8,19,24,18,4,7,7,12,22,48,-15,2.08,1.243243243,1.263157895,1.222222222,0.837837838,1,0.666666667,34.18918919,31.62162162,34.18918919,38,97.4,0.6,Italy-Serie-B,2022/05/06,2022/04/30 15:15
12,Reggina 1914,37,13,9,15,31,46,19,9,2,8,19,24,18,4,7,7,12,22,48,-15,2.08,1.243243243,1.263157895,1.222222222,0.837837838,1,0.666666667,34.18918919,31.62162162,34.18918919,38,97.4,0.6,Italy-Serie-B,2022/05/06,2022/05/06 19:30
13,Como,37,11,14,12,48,52,18,5,7,6,19,19,19,6,7,6,29,33,47,-4,2.7,1.405405405,1.055555556,1.736842105,1.297297297,1.055555556,1.526315789,34.18918919,31.62162162,34.18918919,38,97.4,0.65,Italy-Serie-B,2022/05/06,2022/05/06 19:30
13,Como,37,11,14,12,48,52,18,5,7,6,19,19,19,6,7,6,29,33,47,-4,2.7,1.405405405,1.055555556,1.736842105,1.297297297,1.055555556,1.526315789,34.18918919,31.62162162,34.18918919,38,97.4,0.65,Italy-Serie-B,2022/05/06,2022/04/30 15:15
14,Parma,37,10,16,11,47,43,19,5,9,5,25,20,18,5,7,6,22,23,46,4,2.43,1.162162162,1.052631579,1.277777778,1.27027027,1.315789474,1.222222222,34.18918919,31.62162162,34.18918919,38,97.4,0.7,Italy-Serie-B,2022/05/06,2022/05/06 17:15
15,S.P.A.L.,37,8,15,14,44,53,19,4,8,7,30,28,18,4,7,7,14,25,39,-9,2.62,1.432432432,1.473684211,1.388888889,1.189189189,1.578947368,0.777777778,34.18918919,31.62162162,34.18918919,38,97.4,0.75,Italy-Serie-B,2022/05/06,2022/05/06 19:30
16,Alessandria,37,8,10,19,37,58,18,5,6,7,16,22,19,3,4,12,21,36,34,-21,2.57,1.567567568,1.222222222,1.894736842,1,0.888888889,1.105263158,34.18918919,31.62162162,34.18918919,38,97.4,0.8,Italy-Serie-B,2022/05/06,2022/05/06 19:30
17,Cosenza,37,7,11,19,35,59,18,7,3,8,20,23,19,0,8,11,15,36,32,-24,2.54,1.594594595,1.277777778,1.894736842,0.945945946,1.111111111,0.789473684,34.18918919,31.62162162,34.18918919,38,97.4,0.85,Italy-Serie-B,2022/05/06,2022/05/06 19:30
18,Vicenza,37,8,7,22,37,59,19,5,5,9,22,26,18,3,2,13,15,33,31,-22,2.59,1.594594595,1.368421053,1.833333333,1,1.157894737,0.833333333,34.18918919,31.62162162,34.18918919,38,97.4,0.9,Italy-Serie-B,2022/05/06,2022/04/30 13:00
18,Vicenza,37,8,7,22,37,59,19,5,5,9,22,26,18,3,2,13,15,33,31,-22,2.59,1.594594595,1.368421053,1.833333333,1,1.157894737,0.833333333,34.18918919,31.62162162,34.18918919,38,97.4,0.9,Italy-Serie-B,2022/05/06,2022/05/06 19:30
19,Crotone,37,4,14,19,41,60,18,4,8,6,23,24,19,0,6,13,18,36,26,-19,2.73,1.621621622,1.333333333,1.894736842,1.108108108,1.277777778,0.947368421,34.18918919,31.62162162,34.18918919,38,97.4,0.95,Italy-Serie-B,2022/05/06,2022/05/06 17:15
20,Pordenone,37,3,9,25,29,70,19,2,7,10,19,34,18,1,2,15,10,36,18,-41,2.68,1.891891892,1.789473684,2,0.783783784,1,0.555555556,34.18918919,31.62162162,34.18918919,38,97.4,1,Italy-Serie-B,2022/05/06,2022/05/06 19:30
1,Kashima Ant.,11,8,1,2,17,9,7,4,1,2,8,8,4,4,0,0,9,1,25,8,2.36,0.818181818,1.142857143,0.25,1.545454545,1.142857143,2.25,30.41237113,39.17525773,30.41237113,34,32.4,0.055555556,Japan-J-League,2022/05/06,2022/05/03 07:00
1,Kashima Ant.,11,8,1,2,17,9,7,4,1,2,8,8,4,4,0,0,9,1,25,8,2.36,0.818181818,1.142857143,0.25,1.545454545,1.142857143,2.25,30.41237113,39.17525773,30.41237113,34,32.4,0.055555556,Japan-J-League,2022/05/06,2022/05/07 06:00
2,Kawasaki F,10,6,2,2,15,12,5,4,0,1,6,5,5,2,2,1,9,7,20,3,2.7,1.2,1,1.4,1.5,1.2,1.8,30.41237113,39.17525773,30.41237113,34,29.4,0.111111111,Japan-J-League,2022/05/06,2022/05/07 06:00
3,Kashiwa Rey,11,6,1,4,13,11,5,3,0,2,7,7,6,3,1,2,6,4,19,2,2.18,1,1.4,0.666666667,1.181818182,1.4,1,30.41237113,39.17525773,30.41237113,34,32.4,0.166666667,Japan-J-League,2022/05/06,2022/05/08 08:00
4,Yokohama FM,10,5,3,2,17,11,6,4,2,0,12,5,4,1,1,2,5,6,18,6,2.8,1.1,0.833333333,1.5,1.7,2,1.25,30.41237113,39.17525773,30.41237113,34,29.4,0.222222222,Japan-J-League,2022/05/06,2022/05/07 07:00
5,FC Tokyo,11,5,3,3,11,10,5,3,2,0,7,2,6,2,1,3,4,8,18,1,1.91,0.909090909,0.4,1.333333333,1,1.4,0.666666667,30.41237113,39.17525773,30.41237113,34,32.4,0.277777778,Japan-J-League,2022/05/06,2022/05/08 07:00
5,FC Tokyo,11,5,3,3,11,10,5,3,2,0,7,2,6,2,1,3,4,8,18,1,1.91,0.909090909,0.4,1.333333333,1,1.4,0.666666667,30.41237113,39.17525773,30.41237113,34,32.4,0.277777778,Japan-J-League,2022/05/06,2022/05/03 09:00
6,Sagan Tosu,11,3,7,1,14,7,5,2,3,0,8,2,6,1,4,1,6,5,16,7,1.91,0.636363636,0.4,0.833333333,1.272727273,1.6,1,30.41237113,39.17525773,30.41237113,34,32.4,0.333333333,Japan-J-League,2022/05/06,2022/05/03 07:00
6,Sagan Tosu,11,3,7,1,14,7,5,2,3,0,8,2,6,1,4,1,6,5,16,7,1.91,0.636363636,0.4,0.833333333,1.272727273,1.6,1,30.41237113,39.17525773,30.41237113,34,32.4,0.333333333,Japan-J-League,2022/05/06,2022/05/08 07:00
7,Kyoto PS,11,4,4,3,14,12,6,2,1,3,6,8,5,2,3,0,8,4,16,2,2.36,1.090909091,1.333333333,0.8,1.272727273,1,1.6,30.41237113,39.17525773,30.41237113,34,32.4,0.388888889,Japan-J-League,2022/05/06,2022/05/03 06:00
7,Kyoto PS,11,4,4,3,14,12,6,2,1,3,6,8,5,2,3,0,8,4,16,2,2.36,1.090909091,1.333333333,0.8,1.272727273,1,1.6,30.41237113,39.17525773,30.41237113,34,32.4,0.388888889,Japan-J-League,2022/05/06,2022/05/07 08:00
8,Av. Fukuoka,11,3,5,3,10,7,6,1,4,1,6,3,5,2,1,2,4,4,14,3,1.55,0.636363636,0.5,0.8,0.909090909,1,0.8,30.41237113,39.17525773,30.41237113,34,32.4,0.444444444,Japan-J-League,2022/05/06,2022/05/03 09:00
8,Av. Fukuoka,11,3,5,3,10,7,6,1,4,1,6,3,5,2,1,2,4,4,14,3,1.55,0.636363636,0.5,0.8,0.909090909,1,0.8,30.41237113,39.17525773,30.41237113,34,32.4,0.444444444,Japan-J-League,2022/05/06,2022/05/07 09:00
9,Cerezo Osaka,11,3,5,3,14,13,5,0,2,3,3,8,6,3,3,0,11,5,14,1,2.45,1.181818182,1.6,0.833333333,1.272727273,0.6,1.833333333,30.41237113,39.17525773,30.41237113,34,32.4,0.5,Japan-J-League,2022/05/06,2022/05/06 11:00
9,Cerezo Osaka,11,3,5,3,14,13,5,0,2,3,3,8,6,3,3,0,11,5,14,1,2.45,1.181818182,1.6,0.833333333,1.272727273,0.6,1.833333333,30.41237113,39.17525773,30.41237113,34,32.4,0.5,Japan-J-League,2022/05/06,2022/05/03 07:00
10,S Hiroshima,11,3,5,3,12,12,6,2,2,2,5,5,5,1,3,1,7,7,14,0,2.18,1.090909091,0.833333333,1.4,1.090909091,0.833333333,1.4,30.41237113,39.17525773,30.41237113,34,32.4,0.555555556,Japan-J-League,2022/05/06,2022/05/07 06:00
11,C Sapporo,11,2,8,1,9,11,5,1,4,0,4,3,6,1,4,1,5,8,14,-2,1.82,1,0.6,1.333333333,0.818181818,0.8,0.833333333,30.41237113,39.17525773,30.41237113,34,32.4,0.611111111,Japan-J-League,2022/05/06,2022/05/07 08:00
11,C Sapporo,11,2,8,1,9,11,5,1,4,0,4,3,6,1,4,1,5,8,14,-2,1.82,1,0.6,1.333333333,0.818181818,0.8,0.833333333,30.41237113,39.17525773,30.41237113,34,32.4,0.611111111,Japan-J-League,2022/05/06,2022/05/04 06:00
12,Shimizu SP,11,2,6,3,13,14,5,0,4,1,5,7,6,2,2,2,8,7,12,-1,2.45,1.272727273,1.4,1.166666667,1.181818182,1,1.333333333,30.41237113,39.17525773,30.41237113,34,32.4,0.666666667,Japan-J-League,2022/05/06,2022/05/07 06:00
12,Shimizu SP,11,2,6,3,13,14,5,0,4,1,5,7,6,2,2,2,8,7,12,-1,2.45,1.272727273,1.4,1.166666667,1.181818182,1,1.333333333,30.41237113,39.17525773,30.41237113,34,32.4,0.666666667,Japan-J-League,2022/05/06,2022/05/03 07:00
13,Nagoya G8,11,2,5,4,9,12,6,2,3,1,7,6,5,0,2,3,2,6,11,-3,1.91,1.090909091,1,1.2,0.818181818,1.166666667,0.4,30.41237113,39.17525773,30.41237113,34,32.4,0.722222222,Japan-J-League,2022/05/06,2022/05/03 06:00
13,Nagoya G8,11,2,5,4,9,12,6,2,3,1,7,6,5,0,2,3,2,6,11,-3,1.91,1.090909091,1,1.2,0.818181818,1.166666667,0.4,30.41237113,39.17525773,30.41237113,34,32.4,0.722222222,Japan-J-League,2022/05/06,2022/05/07 07:00
14,Gamba Osaka,11,2,5,4,12,15,6,1,2,3,8,10,5,1,3,1,4,5,11,-3,2.45,1.363636364,1.666666667,1,1.090909091,1.333333333,0.8,30.41237113,39.17525773,30.41237113,34,32.4,0.777777778,Japan-J-League,2022/05/06,2022/05/04 06:00
14,Gamba Osaka,11,2,5,4,12,15,6,1,2,3,8,10,5,1,3,1,4,5,11,-3,2.45,1.363636364,1.666666667,1,1.090909091,1.333333333,0.8,30.41237113,39.17525773,30.41237113,34,32.4,0.777777778,Japan-J-League,2022/05/06,2022/05/08 06:00
15,Jubilo Iwata,11,2,5,4,14,18,5,1,3,1,7,7,6,1,2,3,7,11,11,-4,2.91,1.636363636,1.4,1.833333333,1.272727273,1.4,1.166666667,30.41237113,39.17525773,30.41237113,34,32.4,0.833333333,Japan-J-League,2022/05/06,2022/05/03 07:00
15,Jubilo Iwata,11,2,5,4,14,18,5,1,3,1,7,7,6,1,2,3,7,11,11,-4,2.91,1.636363636,1.4,1.833333333,1.272727273,1.4,1.166666667,30.41237113,39.17525773,30.41237113,34,32.4,0.833333333,Japan-J-League,2022/05/06,2022/05/06 11:00
16,Urawa RD,10,2,4,4,11,10,5,2,2,1,9,5,5,0,2,3,2,5,10,1,2.1,1,1,1,1.1,1.8,0.4,30.41237113,39.17525773,30.41237113,34,29.4,0.888888889,Japan-J-League,2022/05/06,2022/05/08 08:00
17,Shonan Bellmar,11,1,3,7,6,16,5,0,2,3,2,8,6,1,1,4,4,8,6,-10,2,1.454545455,1.6,1.333333333,0.545454545,0.4,0.666666667,30.41237113,39.17525773,30.41237113,34,32.4,0.944444444,Japan-J-League,2022/05/06,2022/05/03 07:00
17,Shonan Bellmar,11,1,3,7,6,16,5,0,2,3,2,8,6,1,1,4,4,8,6,-10,2,1.454545455,1.6,1.333333333,0.545454545,0.4,0.666666667,30.41237113,39.17525773,30.41237113,34,32.4,0.944444444,Japan-J-League,2022/05/06,2022/05/07 09:00
18,Vissel Kobe,10,0,4,6,5,16,4,0,1,3,1,6,6,0,3,3,4,10,4,-11,2.1,1.6,1.5,1.666666667,0.5,0.25,0.666666667,30.41237113,39.17525773,30.41237113,34,29.4,1,Japan-J-League,2022/05/06,2022/05/08 06:00
1,Al Hussein,4,3,1,0,7,1,2,2,0,0,4,0,2,1,1,0,3,1,10,6,2,0.25,0,0.5,1.75,2,1.5,33.33333333,33.33333333,33.33333333,22,18.2,0.083333333,Jordan-League,2022/05/06,2022/04/23 20:30
1,Al Hussein,4,3,1,0,7,1,2,2,0,0,4,0,2,1,1,0,3,1,10,6,2,0.25,0,0.5,1.75,2,1.5,33.33333333,33.33333333,33.33333333,22,18.2,0.083333333,Jordan-League,2022/05/06,2022/05/07 18:00
1,Al Hussein,4,3,1,0,7,1,2,2,0,0,4,0,2,1,1,0,3,1,10,6,2,0.25,0,0.5,1.75,2,1.5,33.33333333,33.33333333,33.33333333,22,18.2,0.083333333,Jordan-League,2022/05/06,2022/05/01 20:30
2,Al Faysali,4,2,2,0,4,2,2,1,1,0,3,2,2,1,1,0,1,0,8,2,1.5,0.5,1,0,1,1.5,0.5,33.33333333,33.33333333,33.33333333,22,18.2,0.166666667,Jordan-League,2022/05/06,2022/04/24 20:30
2,Al Faysali,4,2,2,0,4,2,2,1,1,0,3,2,2,1,1,0,1,0,8,2,1.5,0.5,1,0,1,1.5,0.5,33.33333333,33.33333333,33.33333333,22,18.2,0.166666667,Jordan-League,2022/05/06,2022/04/30 20:30
2,Al Faysali,4,2,2,0,4,2,2,1,1,0,3,2,2,1,1,0,1,0,8,2,1.5,0.5,1,0,1,1.5,0.5,33.33333333,33.33333333,33.33333333,22,18.2,0.166666667,Jordan-League,2022/05/06,2022/05/07 18:00
3,Al Ramtha,4,2,0,2,7,6,3,2,0,1,7,4,1,0,0,1,0,2,6,1,3.25,1.5,1.333333333,2,1.75,2.333333333,0,33.33333333,33.33333333,33.33333333,22,18.2,0.25,Jordan-League,2022/05/06,2022/04/28 20:30
3,Al Ramtha,4,2,0,2,7,6,3,2,0,1,7,4,1,0,0,1,0,2,6,1,3.25,1.5,1.333333333,2,1.75,2.333333333,0,33.33333333,33.33333333,33.33333333,22,18.2,0.25,Jordan-League,2022/05/06,2022/04/23 20:30
3,Al Ramtha,4,2,0,2,7,6,3,2,0,1,7,4,1,0,0,1,0,2,6,1,3.25,1.5,1.333333333,2,1.75,2.333333333,0,33.33333333,33.33333333,33.33333333,22,18.2,0.25,Jordan-League,2022/05/06,2022/05/06 17:00
4,Sh Al Ordon,4,2,0,2,5,6,2,1,0,1,4,4,2,1,0,1,1,2,6,-1,2.75,1.5,2,1,1.25,2,0.5,33.33333333,33.33333333,33.33333333,22,18.2,0.333333333,Jordan-League,2022/05/06,2022/05/04 17:00
4,Sh Al Ordon,4,2,0,2,5,6,2,1,0,1,4,4,2,1,0,1,1,2,6,-1,2.75,1.5,2,1,1.25,2,0.5,33.33333333,33.33333333,33.33333333,22,18.2,0.333333333,Jordan-League,2022/05/06,2022/05/09 18:00
5,Aqaba,3,1,2,0,3,2,1,0,1,0,1,1,2,1,1,0,2,1,5,1,1.67,0.666666667,1,0.5,1,1,1,33.33333333,33.33333333,33.33333333,22,13.6,0.416666667,Jordan-League,2022/05/06,2022/05/09 18:00
5,Aqaba,3,1,2,0,3,2,1,0,1,0,1,1,2,1,1,0,2,1,5,1,1.67,0.666666667,1,0.5,1,1,1,33.33333333,33.33333333,33.33333333,22,13.6,0.416666667,Jordan-League,2022/05/06,2022/04/29 20:30
6,Sahab,4,1,2,1,4,5,3,0,2,1,3,5,1,1,0,0,1,0,5,-1,2.25,1.25,1.666666667,0,1,1,1,33.33333333,33.33333333,33.33333333,22,18.2,0.5,Jordan-League,2022/05/06,2022/05/01 20:30
6,Sahab,4,1,2,1,4,5,3,0,2,1,3,5,1,1,0,0,1,0,5,-1,2.25,1.25,1.666666667,0,1,1,1,33.33333333,33.33333333,33.33333333,22,18.2,0.5,Jordan-League,2022/05/06,2022/04/25 20:30
6,Sahab,4,1,2,1,4,5,3,0,2,1,3,5,1,1,0,0,1,0,5,-1,2.25,1.25,1.666666667,0,1,1,1,33.33333333,33.33333333,33.33333333,22,18.2,0.5,Jordan-League,2022/05/06,2022/05/07 15:30
7,Maan,4,1,2,1,2,4,2,1,1,0,1,0,2,0,1,1,1,4,5,-2,1.5,1,0,2,0.5,0.5,0.5,33.33333333,33.33333333,33.33333333,22,18.2,0.583333333,Jordan-League,2022/05/06,2022/04/27 20:30
7,Maan,4,1,2,1,2,4,2,1,1,0,1,0,2,0,1,1,1,4,5,-2,1.5,1,0,2,0.5,0.5,0.5,33.33333333,33.33333333,33.33333333,22,18.2,0.583333333,Jordan-League,2022/05/06,2022/05/09 15:30
8,Al Wihdat,1,1,0,0,2,1,0,0,0,0,0,0,1,1,0,0,2,1,3,1,3,1,,1,2,,2,33.33333333,33.33333333,33.33333333,22,4.5,0.666666667,Jordan-League,2022/05/06,2022/05/09 15:30
8,Al Wihdat,1,1,0,0,2,1,0,0,0,0,0,0,1,1,0,0,2,1,3,1,3,1,,1,2,,2,33.33333333,33.33333333,33.33333333,22,4.5,0.666666667,Jordan-League,2022/05/06,2022/05/04 17:00
9,Mog Al Sarhan,3,0,3,0,4,4,1,0,1,0,1,1,2,0,2,0,3,3,3,0,2.67,1.333333333,1,1.5,1.333333333,1,1.5,33.33333333,33.33333333,33.33333333,22,13.6,0.75,Jordan-League,2022/05/06,2022/04/29 20:30
9,Mog Al Sarhan,3,0,3,0,4,4,1,0,1,0,1,1,2,0,2,0,3,3,3,0,2.67,1.333333333,1,1.5,1.333333333,1,1.5,33.33333333,33.33333333,33.33333333,22,13.6,0.75,Jordan-League,2022/05/06,2022/04/24 20:30
9,Mog Al Sarhan,3,0,3,0,4,4,1,0,1,0,1,1,2,0,2,0,3,3,3,0,2.67,1.333333333,1,1.5,1.333333333,1,1.5,33.33333333,33.33333333,33.33333333,22,13.6,0.75,Jordan-League,2022/05/06,2022/05/08 17:00
10,Al Sareeh,4,1,0,3,6,7,2,1,0,1,3,1,2,0,0,2,3,6,3,-1,3.25,1.75,0.5,3,1.5,1.5,1.5,33.33333333,33.33333333,33.33333333,22,18.2,0.833333333,Jordan-League,2022/05/06,2022/04/25 20:30
10,Al Sareeh,4,1,0,3,6,7,2,1,0,1,3,1,2,0,0,2,3,6,3,-1,3.25,1.75,0.5,3,1.5,1.5,1.5,33.33333333,33.33333333,33.33333333,22,18.2,0.833333333,Jordan-League,2022/05/06,2022/05/08 17:00
10,Al Sareeh,4,1,0,3,6,7,2,1,0,1,3,1,2,0,0,2,3,6,3,-1,3.25,1.75,0.5,3,1.5,1.5,1.5,33.33333333,33.33333333,33.33333333,22,18.2,0.833333333,Jordan-League,2022/05/06,2022/04/30 20:30
11,Al Salt,3,0,1,2,1,3,1,0,0,1,0,1,2,0,1,1,1,2,1,-2,1.33,1,1,1,0.333333333,0,0.5,33.33333333,33.33333333,33.33333333,22,13.6,0.916666667,Jordan-League,2022/05/06,2022/05/06 17:00
11,Al Salt,3,0,1,2,1,3,1,0,0,1,0,1,2,0,1,1,1,2,1,-2,1.33,1,1,1,0.333333333,0,0.5,33.33333333,33.33333333,33.33333333,22,13.6,0.916666667,Jordan-League,2022/05/06,2022/04/27 20:30
12,Al Jazeera,4,0,1,3,4,8,2,0,1,1,1,2,2,0,0,2,3,6,1,-4,3,2,1,3,1,0.5,1.5,33.33333333,33.33333333,33.33333333,22,18.2,1,Jordan-League,2022/05/06,2022/05/07 15:30
12,Al Jazeera,4,0,1,3,4,8,2,0,1,1,1,2,2,0,0,2,3,6,1,-4,3,2,1,3,1,0.5,1.5,33.33333333,33.33333333,33.33333333,22,18.2,1,Jordan-League,2022/05/06,2022/04/28 20:30
1,Kakamega Hbz,29,15,12,2,48,28,14,7,6,1,24,13,15,8,6,1,24,15,57,20,2.62,0.965517241,0.928571429,1,1.655172414,1.714285714,1.6,32.73092369,34.53815261,32.73092369,34,85.3,0.055555556,Kenya-Premier,2022/05/06,2022/05/01 11:00
1,Kakamega Hbz,29,15,12,2,48,28,14,7,6,1,24,13,15,8,6,1,24,15,57,20,2.62,0.965517241,0.928571429,1,1.655172414,1.714285714,1.6,32.73092369,34.53815261,32.73092369,34,85.3,0.055555556,Kenya-Premier,2022/05/06,2022/05/08 13:00
2,Tusker,28,15,7,6,32,15,14,8,4,2,19,8,14,7,3,4,13,7,52,17,1.68,0.535714286,0.571428571,0.5,1.142857143,1.357142857,0.928571429,32.73092369,34.53815261,32.73092369,34,82.4,0.111111111,Kenya-Premier,2022/05/06,2022/05/08 13:00
2,Tusker,28,15,7,6,32,15,14,8,4,2,19,8,14,7,3,4,13,7,52,17,1.68,0.535714286,0.571428571,0.5,1.142857143,1.357142857,0.928571429,32.73092369,34.53815261,32.73092369,34,82.4,0.111111111,Kenya-Premier,2022/05/06,2022/04/30 13:00
3,Bandari,28,12,11,5,35,23,15,7,5,3,18,12,13,5,6,2,17,11,47,12,2.07,0.821428571,0.8,0.846153846,1.25,1.2,1.307692308,32.73092369,34.53815261,32.73092369,34,82.4,0.166666667,Kenya-Premier,2022/05/06,2022/05/07 11:00
4,Nairobi City,28,13,7,8,37,25,14,5,4,5,17,11,14,8,3,3,20,14,46,12,2.21,0.892857143,0.785714286,1,1.321428571,1.214285714,1.428571429,32.73092369,34.53815261,32.73092369,34,82.4,0.222222222,Kenya-Premier,2022/05/06,2022/05/01 13:00
4,Nairobi City,28,13,7,8,37,25,14,5,4,5,17,11,14,8,3,3,20,14,46,12,2.21,0.892857143,0.785714286,1,1.321428571,1.214285714,1.428571429,32.73092369,34.53815261,32.73092369,34,82.4,0.222222222,Kenya-Premier,2022/05/06,2022/05/07 13:00
5,Gor Mahia,27,12,10,5,28,21,13,7,3,3,13,10,14,5,7,2,15,11,46,7,1.81,0.777777778,0.769230769,0.785714286,1.037037037,1,1.071428571,32.73092369,34.53815261,32.73092369,34,79.4,0.277777778,Kenya-Premier,2022/05/06,2022/05/01 13:00
5,Gor Mahia,27,12,10,5,28,21,13,7,3,3,13,10,14,5,7,2,15,11,46,7,1.81,0.777777778,0.769230769,0.785714286,1.037037037,1,1.071428571,32.73092369,34.53815261,32.73092369,34,79.4,0.277777778,Kenya-Premier,2022/05/06,2022/05/08 13:00
6,Kariob Shrks,28,12,9,7,41,26,14,5,4,5,20,17,14,7,5,2,21,9,45,15,2.39,0.928571429,1.214285714,0.642857143,1.464285714,1.428571429,1.5,32.73092369,34.53815261,32.73092369,34,82.4,0.333333333,Kenya-Premier,2022/05/06,2022/05/07 13:00
6,Kariob Shrks,28,12,9,7,41,26,14,5,4,5,20,17,14,7,5,2,21,9,45,15,2.39,0.928571429,1.214285714,0.642857143,1.464285714,1.428571429,1.5,32.73092369,34.53815261,32.73092369,34,82.4,0.333333333,Kenya-Premier,2022/05/06,2022/05/01 13:00
7,Posta Rangrs,28,12,6,10,41,32,14,5,4,5,19,15,14,7,2,5,22,17,42,9,2.61,1.142857143,1.071428571,1.214285714,1.464285714,1.357142857,1.571428571,32.73092369,34.53815261,32.73092369,34,82.4,0.388888889,Kenya-Premier,2022/05/06,2022/05/07 11:00
8,Kenya CB,28,9,12,7,29,24,14,5,5,4,15,12,14,4,7,3,14,12,39,5,1.89,0.857142857,0.857142857,0.857142857,1.035714286,1.071428571,1,32.73092369,34.53815261,32.73092369,34,82.4,0.444444444,Kenya-Premier,2022/05/06,2022/05/07 13:00
8,Kenya CB,28,9,12,7,29,24,14,5,5,4,15,12,14,4,7,3,14,12,39,5,1.89,0.857142857,0.857142857,0.857142857,1.035714286,1.071428571,1,32.73092369,34.53815261,32.73092369,34,82.4,0.444444444,Kenya-Premier,2022/05/06,2022/05/01 13:00
9,Talanta,28,10,9,9,30,32,14,3,6,5,12,15,14,7,3,4,18,17,39,-2,2.21,1.142857143,1.071428571,1.214285714,1.071428571,0.857142857,1.285714286,32.73092369,34.53815261,32.73092369,34,82.4,0.5,Kenya-Premier,2022/05/06,2022/04/30 13:00
9,Talanta,28,10,9,9,30,32,14,3,6,5,12,15,14,7,3,4,18,17,39,-2,2.21,1.142857143,1.071428571,1.214285714,1.071428571,0.857142857,1.285714286,32.73092369,34.53815261,32.73092369,34,82.4,0.5,Kenya-Premier,2022/05/06,2022/05/07 13:00
10,Leopards SC,27,9,11,7,32,28,14,4,8,2,16,14,13,5,3,5,16,14,38,4,2.22,1.037037037,1,1.076923077,1.185185185,1.142857143,1.230769231,32.73092369,34.53815261,32.73092369,34,79.4,0.555555556,Kenya-Premier,2022/05/06,2022/05/01 13:00
10,Leopards SC,27,9,11,7,32,28,14,4,8,2,16,14,13,5,3,5,16,14,38,4,2.22,1.037037037,1,1.076923077,1.185185185,1.142857143,1.230769231,32.73092369,34.53815261,32.73092369,34,79.4,0.555555556,Kenya-Premier,2022/05/06,2022/05/08 13:00
11,Sofapaka,27,8,12,7,25,23,14,4,5,5,14,15,13,4,7,2,11,8,36,2,1.78,0.851851852,1.071428571,0.615384615,0.925925926,1,0.846153846,32.73092369,34.53815261,32.73092369,34,79.4,0.611111111,Kenya-Premier,2022/05/06,2022/05/01 13:00
11,Sofapaka,27,8,12,7,25,23,14,4,5,5,14,15,13,4,7,2,11,8,36,2,1.78,0.851851852,1.071428571,0.615384615,0.925925926,1,0.846153846,32.73092369,34.53815261,32.73092369,34,79.4,0.611111111,Kenya-Premier,2022/05/06,2022/05/06 13:00
12,Bidco United,28,7,12,9,27,31,13,4,7,2,15,11,15,3,5,7,12,20,33,-4,2.07,1.107142857,0.846153846,1.333333333,0.964285714,1.153846154,0.8,32.73092369,34.53815261,32.73092369,34,82.4,0.666666667,Kenya-Premier,2022/05/06,2022/05/07 13:00
13,Police FC,28,6,13,9,34,33,14,3,5,6,18,19,14,3,8,3,16,14,31,1,2.39,1.178571429,1.357142857,1,1.214285714,1.285714286,1.142857143,32.73092369,34.53815261,32.73092369,34,82.4,0.722222222,Kenya-Premier,2022/05/06,2022/05/01 13:00
13,Police FC,28,6,13,9,34,33,14,3,5,6,18,19,14,3,8,3,16,14,31,1,2.39,1.178571429,1.357142857,1,1.214285714,1.285714286,1.142857143,32.73092369,34.53815261,32.73092369,34,82.4,0.722222222,Kenya-Premier,2022/05/06,2022/05/07 13:00
14,Nzoia Sugar,29,5,14,10,30,35,14,1,7,6,12,18,15,4,7,4,18,17,29,-5,2.24,1.206896552,1.285714286,1.133333333,1.034482759,0.857142857,1.2,32.73092369,34.53815261,32.73092369,34,85.3,0.777777778,Kenya-Premier,2022/05/06,2022/05/07 13:00
14,Nzoia Sugar,29,5,14,10,30,35,14,1,7,6,12,18,15,4,7,4,18,17,29,-5,2.24,1.206896552,1.285714286,1.133333333,1.034482759,0.857142857,1.2,32.73092369,34.53815261,32.73092369,34,85.3,0.777777778,Kenya-Premier,2022/05/06,2022/05/01 13:00
15,Ulinzi Stars,25,6,10,9,16,22,12,4,5,3,10,8,13,2,5,6,6,14,28,-6,1.52,0.88,0.666666667,1.076923077,0.64,0.833333333,0.461538462,32.73092369,34.53815261,32.73092369,34,73.5,0.833333333,Kenya-Premier,2022/05/06,2022/05/07 13:00
16,Wazito,28,5,7,16,27,46,14,3,3,8,15,24,14,2,4,8,12,22,22,-19,2.61,1.642857143,1.714285714,1.571428571,0.964285714,1.071428571,0.857142857,32.73092369,34.53815261,32.73092369,34,82.4,0.888888889,Kenya-Premier,2022/05/06,2022/05/07 13:00
16,Wazito,28,5,7,16,27,46,14,3,3,8,15,24,14,2,4,8,12,22,22,-19,2.61,1.642857143,1.714285714,1.571428571,0.964285714,1.071428571,0.857142857,32.73092369,34.53815261,32.73092369,34,82.4,0.888888889,Kenya-Premier,2022/05/06,2022/05/01 11:00
17,Vihiga Utd,27,4,8,15,17,44,15,3,5,7,13,20,12,1,3,8,4,24,20,-27,2.26,1.62962963,1.333333333,2,0.62962963,0.866666667,0.333333333,32.73092369,34.53815261,32.73092369,34,79.4,0.944444444,Kenya-Premier,2022/05/06,2022/05/07 13:00
18,Mathare Utd,27,3,2,22,18,59,13,0,0,13,5,30,14,3,2,9,13,29,11,-41,2.85,2.185185185,2.307692308,2.071428571,0.666666667,0.384615385,0.928571429,32.73092369,34.53815261,32.73092369,34,79.4,1,Kenya-Premier,2022/05/06,2022/05/06 13:00
1,Changwon Cy,10,5,3,2,13,5,5,3,1,1,8,1,5,2,2,1,5,4,18,8,1.8,0.5,0.2,0.8,1.3,1.6,1,36.36363636,27.27272727,36.36363636,30,33.3,0.0625,Korea-K3-League,2022/05/06,2022/05/07 07:00
1,Changwon Cy,10,5,3,2,13,5,5,3,1,1,8,1,5,2,2,1,5,4,18,8,1.8,0.5,0.2,0.8,1.3,1.6,1,36.36363636,27.27272727,36.36363636,30,33.3,0.0625,Korea-K3-League,2022/05/06,2022/05/01 07:00
2,Gyeongju HNP,10,5,3,2,16,10,6,2,2,2,7,6,4,3,1,0,9,4,18,6,2.6,1,1,1,1.6,1.166666667,2.25,36.36363636,27.27272727,36.36363636,30,33.3,0.125,Korea-K3-League,2022/05/06,2022/05/01 07:00
2,Gyeongju HNP,10,5,3,2,16,10,6,2,2,2,7,6,4,3,1,0,9,4,18,6,2.6,1,1,1,1.6,1.166666667,2.25,36.36363636,27.27272727,36.36363636,30,33.3,0.125,Korea-K3-League,2022/05/06,2022/05/07 09:00
3,Siheung Cit,10,5,2,3,11,9,6,4,2,0,9,3,4,1,0,3,2,6,17,2,2,0.9,0.5,1.5,1.1,1.5,0.5,36.36363636,27.27272727,36.36363636,30,33.3,0.1875,Korea-K3-League,2022/05/06,2022/05/01 06:00
3,Siheung Cit,10,5,2,3,11,9,6,4,2,0,9,3,4,1,0,3,2,6,17,2,2,0.9,0.5,1.5,1.1,1.5,0.5,36.36363636,27.27272727,36.36363636,30,33.3,0.1875,Korea-K3-League,2022/05/06,2022/05/08 07:00
4,Gangneung City,10,4,4,2,10,9,5,3,2,0,5,2,5,1,2,2,5,7,16,1,1.9,0.9,0.4,1.4,1,1,1,36.36363636,27.27272727,36.36363636,30,33.3,0.25,Korea-K3-League,2022/05/06,2022/05/06 11:00
4,Gangneung City,10,4,4,2,10,9,5,3,2,0,5,2,5,1,2,2,5,7,16,1,1.9,0.9,0.4,1.4,1,1,1,36.36363636,27.27272727,36.36363636,30,33.3,0.25,Korea-K3-League,2022/05/06,2022/05/01 07:00
5,Gimhae City,10,5,1,4,11,10,4,2,1,1,6,4,6,3,0,3,5,6,16,1,2.1,1,1,1,1.1,1.5,0.833333333,36.36363636,27.27272727,36.36363636,30,33.3,0.3125,Korea-K3-League,2022/05/06,2022/05/08 09:00
6,Cheongju Jik,10,4,3,3,10,9,5,3,0,2,7,6,5,1,3,1,3,3,15,1,1.9,0.9,1.2,0.6,1,1.4,0.6,36.36363636,27.27272727,36.36363636,30,33.3,0.375,Korea-K3-League,2022/05/06,2022/04/30 07:00
6,Cheongju Jik,10,4,3,3,10,9,5,3,0,2,7,6,5,1,3,1,3,3,15,1,1.9,0.9,1.2,0.6,1,1.4,0.6,36.36363636,27.27272727,36.36363636,30,33.3,0.375,Korea-K3-League,2022/05/06,2022/05/08 07:00
7,Ulsan Citizn,10,4,2,4,12,11,5,2,1,2,5,5,5,2,1,2,7,6,14,1,2.3,1.1,1,1.2,1.2,1,1.4,36.36363636,27.27272727,36.36363636,30,33.3,0.4375,Korea-K3-League,2022/05/06,2022/05/08 09:00
7,Ulsan Citizn,10,4,2,4,12,11,5,2,1,2,5,5,5,2,1,2,7,6,14,1,2.3,1.1,1,1.2,1.2,1,1.4,36.36363636,27.27272727,36.36363636,30,33.3,0.4375,Korea-K3-League,2022/05/06,2022/05/01 07:00
8,Busan Kyot,10,3,4,3,11,10,8,2,3,3,9,10,2,1,1,0,2,0,13,1,2.1,1,1.25,0,1.1,1.125,1,36.36363636,27.27272727,36.36363636,30,33.3,0.5,Korea-K3-League,2022/05/06,2022/05/01 07:00
8,Busan Kyot,10,3,4,3,11,10,8,2,3,3,9,10,2,1,1,0,2,0,13,1,2.1,1,1.25,0,1.1,1.125,1,36.36363636,27.27272727,36.36363636,30,33.3,0.5,Korea-K3-League,2022/05/06,2022/05/07 06:00
9,Paju Citizen,9,3,4,2,9,9,4,2,0,2,5,6,5,1,4,0,4,3,13,0,2,1,1.5,0.6,1,1.25,0.8,36.36363636,27.27272727,36.36363636,30,30,0.5625,Korea-K3-League,2022/05/06,2022/05/08 07:00
9,Paju Citizen,9,3,4,2,9,9,4,2,0,2,5,6,5,1,4,0,4,3,13,0,2,1,1.5,0.6,1,1.25,0.8,36.36363636,27.27272727,36.36363636,30,30,0.5625,Korea-K3-League,2022/05/06,2022/05/01 06:00
10,Yangju Citzn,10,4,0,6,7,8,3,1,0,2,2,2,7,3,0,4,5,6,12,-1,1.5,0.8,0.666666667,0.857142857,0.7,0.666666667,0.714285714,36.36363636,27.27272727,36.36363636,30,33.3,0.625,Korea-K3-League,2022/05/06,2022/05/07 09:00
10,Yangju Citzn,10,4,0,6,7,8,3,1,0,2,2,2,7,3,0,4,5,6,12,-1,1.5,0.8,0.666666667,0.857142857,0.7,0.666666667,0.714285714,36.36363636,27.27272727,36.36363636,30,33.3,0.625,Korea-K3-League,2022/05/06,2022/04/30 07:00
11,Cheonan,9,2,5,2,7,7,3,0,1,2,2,4,6,2,4,0,5,3,11,0,1.56,0.777777778,1.333333333,0.5,0.777777778,0.666666667,0.833333333,36.36363636,27.27272727,36.36363636,30,30,0.6875,Korea-K3-League,2022/05/06,2022/05/08 07:00
11,Cheonan,9,2,5,2,7,7,3,0,1,2,2,4,6,2,4,0,5,3,11,0,1.56,0.777777778,1.333333333,0.5,0.777777778,0.666666667,0.833333333,36.36363636,27.27272727,36.36363636,30,30,0.6875,Korea-K3-League,2022/05/06,2022/05/01 07:00
12,Hwaseong,8,3,2,3,8,9,6,2,1,3,6,8,2,1,1,0,2,1,11,-1,2.12,1.125,1.333333333,0.5,1,1,1,36.36363636,27.27272727,36.36363636,30,26.7,0.75,Korea-K3-League,2022/05/06,2022/05/01 07:00
12,Hwaseong,8,3,2,3,8,9,6,2,1,3,6,8,2,1,1,0,2,1,11,-1,2.12,1.125,1.333333333,0.5,1,1,1,36.36363636,27.27272727,36.36363636,30,26.7,0.75,Korea-K3-League,2022/05/06,2022/05/06 11:00
13,Daejeon Korl,9,3,2,4,7,10,4,2,1,1,3,2,5,1,1,3,4,8,11,-3,1.89,1.111111111,0.5,1.6,0.777777778,0.75,0.8,36.36363636,27.27272727,36.36363636,30,30,0.8125,Korea-K3-League,2022/05/06,2022/05/01 07:00
13,Daejeon Korl,9,3,2,4,7,10,4,2,1,1,3,2,5,1,1,3,4,8,11,-3,1.89,1.111111111,0.5,1.6,0.777777778,0.75,0.8,36.36363636,27.27272727,36.36363636,30,30,0.8125,Korea-K3-League,2022/05/06,2022/05/07 06:00
14,Mokpo City,9,3,2,4,6,11,3,0,2,1,0,1,6,3,0,3,6,10,11,-5,1.89,1.222222222,0.333333333,1.666666667,0.666666667,0,1,36.36363636,27.27272727,36.36363636,30,30,0.875,Korea-K3-League,2022/05/06,2022/05/07 07:00
14,Mokpo City,9,3,2,4,6,11,3,0,2,1,0,1,6,3,0,3,6,10,11,-5,1.89,1.222222222,0.333333333,1.666666667,0.666666667,0,1,36.36363636,27.27272727,36.36363636,30,30,0.875,Korea-K3-League,2022/05/06,2022/05/01 07:00
15,Pocheon,9,2,2,5,9,11,5,2,2,1,6,4,4,0,0,4,3,7,8,-2,2.22,1.222222222,0.8,1.75,1,1.2,0.75,36.36363636,27.27272727,36.36363636,30,30,0.9375,Korea-K3-League,2022/05/06,2022/05/07 07:00
16,Dangjin Citz,11,1,3,7,10,19,5,1,2,2,5,8,6,0,1,5,5,11,6,-9,2.64,1.727272727,1.6,1.833333333,0.909090909,1,0.833333333,36.36363636,27.27272727,36.36363636,30,36.7,1,Korea-K3-League,2022/05/06,2022/05/01 07:00
16,Dangjin Citz,11,1,3,7,10,19,5,1,2,2,5,8,6,0,1,5,5,11,6,-9,2.64,1.727272727,1.6,1.833333333,0.909090909,1,0.833333333,36.36363636,27.27272727,36.36363636,30,36.7,1,Korea-K3-League,2022/05/06,2022/05/07 07:00
1,Rigas Skola,11,8,2,1,32,10,6,4,1,1,11,4,5,4,1,0,21,6,26,22,3.82,0.909090909,0.666666667,1.2,2.909090909,1.833333333,4.2,40,20,40,18,61.1,0.1,Latvia-Virsliga,2022/05/06,2022/05/01 14:00
1,Rigas Skola,11,8,2,1,32,10,6,4,1,1,11,4,5,4,1,0,21,6,26,22,3.82,0.909090909,0.666666667,1.2,2.909090909,1.833333333,4.2,40,20,40,18,61.1,0.1,Latvia-Virsliga,2022/05/06,2022/05/05 15:30
2,FK Valmiera,11,8,2,1,28,7,5,4,1,0,14,2,6,4,1,1,14,5,26,21,3.18,0.636363636,0.4,0.833333333,2.545454545,2.8,2.333333333,40,20,40,18,61.1,0.2,Latvia-Virsliga,2022/05/06,2022/05/01 12:00
2,FK Valmiera,11,8,2,1,28,7,5,4,1,0,14,2,6,4,1,1,14,5,26,21,3.18,0.636363636,0.4,0.833333333,2.545454545,2.8,2.333333333,40,20,40,18,61.1,0.2,Latvia-Virsliga,2022/05/06,2022/05/05 16:00
2,FK Valmiera,11,8,2,1,28,7,5,4,1,0,14,2,6,4,1,1,14,5,26,21,3.18,0.636363636,0.4,0.833333333,2.545454545,2.8,2.333333333,40,20,40,18,61.1,0.2,Latvia-Virsliga,2022/05/06,2022/05/09 16:00
3,FK Liepaja,10,7,1,2,26,12,5,3,1,1,12,6,5,4,0,1,14,6,22,14,3.8,1.2,1.2,1.2,2.6,2.4,2.8,40,20,40,18,55.6,0.3,Latvia-Virsliga,2022/05/06,2022/05/10 16:00
3,FK Liepaja,10,7,1,2,26,12,5,3,1,1,12,6,5,4,0,1,14,6,22,14,3.8,1.2,1.2,1.2,2.6,2.4,2.8,40,20,40,18,55.6,0.3,Latvia-Virsliga,2022/05/06,2022/05/02 17:00
3,FK Liepaja,10,7,1,2,26,12,5,3,1,1,12,6,5,4,0,1,14,6,22,14,3.8,1.2,1.2,1.2,2.6,2.4,2.8,40,20,40,18,55.6,0.3,Latvia-Virsliga,2022/05/06,2022/05/06 16:00
4,Riga FC,10,6,1,3,14,7,5,5,0,0,12,1,5,1,1,3,2,6,19,7,2.1,0.7,0.2,1.2,1.4,2.4,0.4,40,20,40,18,55.6,0.4,Latvia-Virsliga,2022/05/06,2022/05/06 16:00
4,Riga FC,10,6,1,3,14,7,5,5,0,0,12,1,5,1,1,3,2,6,19,7,2.1,0.7,0.2,1.2,1.4,2.4,0.4,40,20,40,18,55.6,0.4,Latvia-Virsliga,2022/05/06,2022/05/01 12:00
4,Riga FC,10,6,1,3,14,7,5,5,0,0,12,1,5,1,1,3,2,6,19,7,2.1,0.7,0.2,1.2,1.4,2.4,0.4,40,20,40,18,55.6,0.4,Latvia-Virsliga,2022/05/06,2022/05/10 17:00
5,Auda Riga,9,4,3,2,9,8,4,2,0,2,5,6,5,2,3,0,4,2,15,1,1.89,0.888888889,1.5,0.4,1,1.25,0.8,40,20,40,18,50,0.5,Latvia-Virsliga,2022/05/06,2022/05/02 15:30
5,Auda Riga,9,4,3,2,9,8,4,2,0,2,5,6,5,2,3,0,4,2,15,1,1.89,0.888888889,1.5,0.4,1,1.25,0.8,40,20,40,18,50,0.5,Latvia-Virsliga,2022/05/06,2022/05/06 11:00
5,Auda Riga,9,4,3,2,9,8,4,2,0,2,5,6,5,2,3,0,4,2,15,1,1.89,0.888888889,1.5,0.4,1,1.25,0.8,40,20,40,18,50,0.5,Latvia-Virsliga,2022/05/06,2022/05/10 15:00
6,BFC Daugava,10,4,3,3,9,14,6,3,2,1,7,5,4,1,1,2,2,9,15,-5,2.3,1.4,0.833333333,2.25,0.9,1.166666667,0.5,40,20,40,18,55.6,0.6,Latvia-Virsliga,2022/05/06,2022/05/05 15:30
6,BFC Daugava,10,4,3,3,9,14,6,3,2,1,7,5,4,1,1,2,2,9,15,-5,2.3,1.4,0.833333333,2.25,0.9,1.166666667,0.5,40,20,40,18,55.6,0.6,Latvia-Virsliga,2022/05/06,2022/05/09 16:00
6,BFC Daugava,10,4,3,3,9,14,6,3,2,1,7,5,4,1,1,2,2,9,15,-5,2.3,1.4,0.833333333,2.25,0.9,1.166666667,0.5,40,20,40,18,55.6,0.6,Latvia-Virsliga,2022/05/06,2022/04/30 14:00
7,Metta Lu,10,2,3,5,10,19,4,1,1,2,4,7,6,1,2,3,6,12,9,-9,2.9,1.9,1.75,2,1,1,1,40,20,40,18,55.6,0.7,Latvia-Virsliga,2022/05/06,2022/05/06 16:30
7,Metta Lu,10,2,3,5,10,19,4,1,1,2,4,7,6,1,2,3,6,12,9,-9,2.9,1.9,1.75,2,1,1,1,40,20,40,18,55.6,0.7,Latvia-Virsliga,2022/05/06,2022/04/28 16:00
7,Metta Lu,10,2,3,5,10,19,4,1,1,2,4,7,6,1,2,3,6,12,9,-9,2.9,1.9,1.75,2,1,1,1,40,20,40,18,55.6,0.7,Latvia-Virsliga,2022/05/06,2022/05/02 15:30
8,Tukums,9,1,1,7,5,24,4,0,1,3,3,17,5,1,0,4,2,7,4,-19,3.22,2.666666667,4.25,1.4,0.555555556,0.75,0.4,40,20,40,18,50,0.8,Latvia-Virsliga,2022/05/06,2022/04/30 14:00
8,Tukums,9,1,1,7,5,24,4,0,1,3,3,17,5,1,0,4,2,7,4,-19,3.22,2.666666667,4.25,1.4,0.555555556,0.75,0.4,40,20,40,18,50,0.8,Latvia-Virsliga,2022/05/06,2022/05/10 15:00
8,Tukums,9,1,1,7,5,24,4,0,1,3,3,17,5,1,0,4,2,7,4,-19,3.22,2.666666667,4.25,1.4,0.555555556,0.75,0.4,40,20,40,18,50,0.8,Latvia-Virsliga,2022/05/06,2022/05/06 16:30
9,Super Nova,10,0,3,7,3,17,6,0,2,4,2,10,4,0,1,3,1,7,3,-14,2,1.7,1.666666667,1.75,0.3,0.333333333,0.25,40,20,40,18,55.6,0.9,Latvia-Virsliga,2022/05/06,2022/04/28 16:00
9,Super Nova,10,0,3,7,3,17,6,0,2,4,2,10,4,0,1,3,1,7,3,-14,2,1.7,1.666666667,1.75,0.3,0.333333333,0.25,40,20,40,18,55.6,0.9,Latvia-Virsliga,2022/05/06,2022/05/02 17:00
9,Super Nova,10,0,3,7,3,17,6,0,2,4,2,10,4,0,1,3,1,7,3,-14,2,1.7,1.666666667,1.75,0.3,0.333333333,0.25,40,20,40,18,55.6,0.9,Latvia-Virsliga,2022/05/06,2022/05/10 17:00
9,Super Nova,10,0,3,7,3,17,6,0,2,4,2,10,4,0,1,3,1,7,3,-14,2,1.7,1.666666667,1.75,0.3,0.333333333,0.25,40,20,40,18,55.6,0.9,Latvia-Virsliga,2022/05/06,2022/05/06 11:00
10,Sp Jurmala,10,0,1,9,4,22,5,0,1,4,3,9,5,0,0,5,1,13,1,-18,2.6,2.2,1.8,2.6,0.4,0.6,0.2,40,20,40,18,55.6,1,Latvia-Virsliga,2022/05/06,2022/05/05 16:00
10,Sp Jurmala,10,0,1,9,4,22,5,0,1,4,3,9,5,0,0,5,1,13,1,-18,2.6,2.2,1.8,2.6,0.4,0.6,0.2,40,20,40,18,55.6,1,Latvia-Virsliga,2022/05/06,2022/05/01 14:00
10,Sp Jurmala,10,0,1,9,4,22,5,0,1,4,3,9,5,0,0,5,1,13,1,-18,2.6,2.2,1.8,2.6,0.4,0.6,0.2,40,20,40,18,55.6,1,Latvia-Virsliga,2022/05/06,2022/05/10 16:00
1,Al Ahly Beng,18,14,2,2,27,7,9,7,1,1,16,5,9,7,1,1,11,2,44,20,1.89,0.388888889,0.555555556,0.222222222,1.5,1.777777778,1.222222222,32.46753247,35.06493506,32.46753247,38,47.4,0.05,Libya-Premier,2022/05/06,2022/04/22 22:00
1,Al Ahly Beng,18,14,2,2,27,7,9,7,1,1,16,5,9,7,1,1,11,2,44,20,1.89,0.388888889,0.555555556,0.222222222,1.5,1.777777778,1.222222222,32.46753247,35.06493506,32.46753247,38,47.4,0.05,Libya-Premier,2022/05/06,2022/04/16 22:00
2,Al Nasr Lib,18,11,4,3,35,14,9,7,1,1,21,6,9,4,3,2,14,8,37,21,2.72,0.777777778,0.666666667,0.888888889,1.944444444,2.333333333,1.555555556,32.46753247,35.06493506,32.46753247,38,47.4,0.1,Libya-Premier,2022/05/06,2022/04/17 22:00
2,Al Nasr Lib,18,11,4,3,35,14,9,7,1,1,21,6,9,4,3,2,14,8,37,21,2.72,0.777777778,0.666666667,0.888888889,1.944444444,2.333333333,1.555555556,32.46753247,35.06493506,32.46753247,38,47.4,0.1,Libya-Premier,2022/05/06,2022/04/22 22:00
3,Al Akhdar Lb,17,10,5,2,37,14,9,6,2,1,19,3,8,4,3,1,18,11,35,23,3,0.823529412,0.333333333,1.375,2.176470588,2.111111111,2.25,32.46753247,35.06493506,32.46753247,38,44.7,0.15,Libya-Premier,2022/05/06,2022/04/16 22:00
4,Al Ittihad Lb,11,7,4,0,16,3,6,3,3,0,9,1,5,4,1,0,7,2,25,13,1.73,0.272727273,0.166666667,0.4,1.454545455,1.5,1.4,32.46753247,35.06493506,32.46753247,38,28.9,0.2,Libya-Premier,2022/05/06,2022/05/10 15:30
4,Al Ittihad Lb,11,7,4,0,16,3,6,3,3,0,9,1,5,4,1,0,7,2,25,13,1.73,0.272727273,0.166666667,0.4,1.454545455,1.5,1.4,32.46753247,35.06493506,32.46753247,38,28.9,0.2,Libya-Premier,2022/05/06,2022/05/10 15:30
4,Al Ittihad Lb,11,7,4,0,16,3,6,3,3,0,9,1,5,4,1,0,7,2,25,13,1.73,0.272727273,0.166666667,0.4,1.454545455,1.5,1.4,32.46753247,35.06493506,32.46753247,38,28.9,0.2,Libya-Premier,2022/05/06,2022/04/28 22:00
4,Al Ittihad Lb,11,7,4,0,16,3,6,3,3,0,9,1,5,4,1,0,7,2,25,13,1.73,0.272727273,0.166666667,0.4,1.454545455,1.5,1.4,32.46753247,35.06493506,32.46753247,38,28.9,0.2,Libya-Premier,2022/05/06,2022/05/06 15:30
5,Oly Azzawe,14,7,4,3,17,15,6,2,2,2,4,4,8,5,2,1,13,11,25,2,2.29,1.071428571,0.666666667,1.375,1.214285714,0.666666667,1.625,32.46753247,35.06493506,32.46753247,38,36.8,0.25,Libya-Premier,2022/05/06,2022/05/09 15:30
5,Oly Azzawe,14,7,4,3,17,15,6,2,2,2,4,4,8,5,2,1,13,11,25,2,2.29,1.071428571,0.666666667,1.375,1.214285714,0.666666667,1.625,32.46753247,35.06493506,32.46753247,38,36.8,0.25,Libya-Premier,2022/05/06,2022/05/09 15:30
6,Al Hilal Ben,17,6,6,5,13,12,8,4,3,1,9,6,9,2,3,4,4,6,24,1,1.47,0.705882353,0.75,0.666666667,0.764705882,1.125,0.444444444,32.46753247,35.06493506,32.46753247,38,44.7,0.3,Libya-Premier,2022/05/06,2022/04/15 22:00
7,Al Ahly Lib,10,6,4,0,14,4,4,2,2,0,6,3,6,4,2,0,8,1,22,10,1.8,0.4,0.75,0.166666667,1.4,1.5,1.333333333,32.46753247,35.06493506,32.46753247,38,26.3,0.35,Libya-Premier,2022/05/06,2022/04/28 22:00
8,Al Athad Lib,15,5,7,3,14,11,8,2,4,2,6,6,7,3,3,1,8,5,22,3,1.67,0.733333333,0.75,0.714285714,0.933333333,0.75,1.142857143,32.46753247,35.06493506,32.46753247,38,39.5,0.4,Libya-Premier,2022/05/06,2022/04/28 22:00
8,Al Athad Lib,15,5,7,3,14,11,8,2,4,2,6,6,7,3,3,1,8,5,22,3,1.67,0.733333333,0.75,0.714285714,0.933333333,0.75,1.142857143,32.46753247,35.06493506,32.46753247,38,39.5,0.4,Libya-Premier,2022/05/06,2022/05/10 15:30
8,Al Athad Lib,15,5,7,3,14,11,8,2,4,2,6,6,7,3,3,1,8,5,22,3,1.67,0.733333333,0.75,0.714285714,0.933333333,0.75,1.142857143,32.46753247,35.06493506,32.46753247,38,39.5,0.4,Libya-Premier,2022/05/06,2022/05/10 15:30
9,Al Sadaqa,17,5,6,6,14,17,9,4,3,2,10,7,8,1,3,4,4,10,21,-3,1.82,1,0.777777778,1.25,0.823529412,1.111111111,0.5,32.46753247,35.06493506,32.46753247,38,44.7,0.45,Libya-Premier,2022/05/06,2022/04/17 22:00
10,Al Taawun Lb,17,5,5,7,21,18,9,4,2,3,10,6,8,1,3,4,11,12,20,3,2.29,1.058823529,0.666666667,1.5,1.235294118,1.111111111,1.375,32.46753247,35.06493506,32.46753247,38,44.7,0.5,Libya-Premier,2022/05/06,2022/04/15 22:00
11,Asswehly,15,4,7,4,16,14,8,2,4,2,10,9,7,2,3,2,6,5,19,2,2,0.933333333,1.125,0.714285714,1.066666667,1.25,0.857142857,32.46753247,35.06493506,32.46753247,38,39.5,0.55,Libya-Premier,2022/05/06,
12,Al Madina,14,3,8,3,12,11,8,2,4,2,7,5,6,1,4,1,5,6,17,1,1.64,0.785714286,0.625,1,0.857142857,0.875,0.833333333,32.46753247,35.06493506,32.46753247,38,36.8,0.6,Libya-Premier,2022/05/06,2022/05/10 15:30
12,Al Madina,14,3,8,3,12,11,8,2,4,2,7,5,6,1,4,1,5,6,17,1,1.64,0.785714286,0.625,1,0.857142857,0.875,0.833333333,32.46753247,35.06493506,32.46753247,38,36.8,0.6,Libya-Premier,2022/05/06,2022/05/10 15:30
13,Abu Salim,14,3,7,4,7,10,6,1,2,3,3,7,8,2,5,1,4,3,16,-3,1.21,0.714285714,1.166666667,0.375,0.5,0.5,0.5,32.46753247,35.06493506,32.46753247,38,36.8,0.65,Libya-Premier,2022/05/06,2022/05/09 15:30
13,Abu Salim,14,3,7,4,7,10,6,1,2,3,3,7,8,2,5,1,4,3,16,-3,1.21,0.714285714,1.166666667,0.375,0.5,0.5,0.5,32.46753247,35.06493506,32.46753247,38,36.8,0.65,Libya-Premier,2022/05/06,2022/05/09 15:30
14,Darnes,17,3,6,8,14,23,8,2,5,1,5,2,9,1,1,7,9,21,15,-9,2.18,1.352941176,0.25,2.333333333,0.823529412,0.625,1,32.46753247,35.06493506,32.46753247,38,44.7,0.7,Libya-Premier,2022/05/06,2022/04/15 22:00
15,Mahalla Trip,15,2,8,5,12,19,7,1,3,3,8,13,8,1,5,2,4,6,14,-7,2.07,1.266666667,1.857142857,0.75,0.8,1.142857143,0.5,32.46753247,35.06493506,32.46753247,38,39.5,0.75,Libya-Premier,2022/05/06,2022/04/28 22:00
16,Al Tahaddi,17,3,5,9,13,26,8,3,1,4,9,16,9,0,4,5,4,10,14,-13,2.29,1.529411765,2,1.111111111,0.764705882,1.125,0.444444444,32.46753247,35.06493506,32.46753247,38,44.7,0.8,Libya-Premier,2022/05/06,2022/04/15 22:00
17,Shab Jabal,17,3,4,10,13,34,9,2,3,4,8,14,8,1,1,6,5,20,13,-21,2.76,2,1.555555556,2.5,0.764705882,0.888888889,0.625,32.46753247,35.06493506,32.46753247,38,44.7,0.85,Libya-Premier,2022/05/06,2022/04/17 22:00
18,Al Khmes,14,2,6,6,12,15,9,2,3,4,9,9,5,0,3,2,3,6,12,-3,1.93,1.071428571,1,1.2,0.857142857,1,0.6,32.46753247,35.06493506,32.46753247,38,36.8,0.9,Libya-Premier,2022/05/06,2022/05/06 15:30
19,Khaleej Sirt,17,1,7,9,16,38,8,1,4,3,12,19,9,0,3,6,4,19,10,-22,3.18,2.235294118,2.375,2.111111111,0.941176471,1.5,0.444444444,32.46753247,35.06493506,32.46753247,38,44.7,0.95,Libya-Premier,2022/05/06,2022/04/17 22:00
20,Al Shat,14,0,3,11,5,23,6,0,2,4,0,6,8,0,1,7,5,17,3,-18,2,1.642857143,1,2.125,0.357142857,0,0.625,32.46753247,35.06493506,32.46753247,38,36.8,1,Libya-Premier,2022/05/06,2022/05/10 15:30
20,Al Shat,14,0,3,11,5,23,6,0,2,4,0,6,8,0,1,7,5,17,3,-18,2,1.642857143,1,2.125,0.357142857,0,0.625,32.46753247,35.06493506,32.46753247,38,36.8,1,Libya-Premier,2022/05/06,2022/05/10 15:30
1,Johor FC,4,4,0,0,12,1,3,3,0,0,9,1,1,1,0,0,3,0,12,11,3.25,0.25,0.333333333,0,3,3,3,40.625,18.75,40.625,22,18.2,0.083333333,Malaysia-Super,2022/05/06,2022/05/06 14:00
2,Sabah,6,4,0,2,9,4,3,2,0,1,7,2,3,2,0,1,2,2,12,5,2.17,0.666666667,0.666666667,0.666666667,1.5,2.333333333,0.666666667,40.625,18.75,40.625,22,27.3,0.166666667,Malaysia-Super,2022/05/06,2022/04/24 14:15
2,Sabah,6,4,0,2,9,4,3,2,0,1,7,2,3,2,0,1,2,2,12,5,2.17,0.666666667,0.666666667,0.666666667,1.5,2.333333333,0.666666667,40.625,18.75,40.625,22,27.3,0.166666667,Malaysia-Super,2022/05/06,2022/05/07 14:00
3,Kedah,6,4,0,2,8,11,2,2,0,0,4,2,4,2,0,2,4,9,12,-3,3.17,1.833333333,1,2.25,1.333333333,2,1,40.625,18.75,40.625,22,27.3,0.25,Malaysia-Super,2022/05/06,2022/05/06 14:00
3,Kedah,6,4,0,2,8,11,2,2,0,0,4,2,4,2,0,2,4,9,12,-3,3.17,1.833333333,1,2.25,1.333333333,2,1,40.625,18.75,40.625,22,27.3,0.25,Malaysia-Super,2022/05/06,2022/04/24 14:15
3,Kedah,6,4,0,2,8,11,2,2,0,0,4,2,4,2,0,2,4,9,12,-3,3.17,1.833333333,1,2.25,1.333333333,2,1,40.625,18.75,40.625,22,27.3,0.25,Malaysia-Super,2022/05/06,2022/05/10 14:00
4,Negeri Sem,5,3,2,0,9,5,3,2,1,0,7,4,2,1,1,0,2,1,11,4,2.8,1,1.333333333,0.5,1.8,2.333333333,1,40.625,18.75,40.625,22,22.7,0.333333333,Malaysia-Super,2022/05/06,2022/04/24 15:00
4,Negeri Sem,5,3,2,0,9,5,3,2,1,0,7,4,2,1,1,0,2,1,11,4,2.8,1,1.333333333,0.5,1.8,2.333333333,1,40.625,18.75,40.625,22,22.7,0.333333333,Malaysia-Super,2022/05/06,2022/05/06 13:15
5,Selangor,5,2,2,1,12,9,2,2,0,0,7,2,3,0,2,1,5,7,8,3,4.2,1.8,1,2.333333333,2.4,3.5,1.666666667,40.625,18.75,40.625,22,22.7,0.416666667,Malaysia-Super,2022/05/06,2022/04/29 15:00
5,Selangor,5,2,2,1,12,9,2,2,0,0,7,2,3,0,2,1,5,7,8,3,4.2,1.8,1,2.333333333,2.4,3.5,1.666666667,40.625,18.75,40.625,22,22.7,0.416666667,Malaysia-Super,2022/05/06,2022/05/07 14:00
5,Selangor,5,2,2,1,12,9,2,2,0,0,7,2,3,0,2,1,5,7,8,3,4.2,1.8,1,2.333333333,2.4,3.5,1.666666667,40.625,18.75,40.625,22,22.7,0.416666667,Malaysia-Super,2022/05/06,2022/04/22 15:00
5,Selangor,5,2,2,1,12,9,2,2,0,0,7,2,3,0,2,1,5,7,8,3,4.2,1.8,1,2.333333333,2.4,3.5,1.666666667,40.625,18.75,40.625,22,22.7,0.416666667,Malaysia-Super,2022/05/06,2022/05/10 13:15
6,Ku Lumpur,6,2,1,3,10,11,4,2,1,1,7,6,2,0,0,2,3,5,7,-1,3.5,1.833333333,1.5,2.5,1.666666667,1.75,1.5,40.625,18.75,40.625,22,27.3,0.5,Malaysia-Super,2022/05/06,2022/05/07 13:15
6,Ku Lumpur,6,2,1,3,10,11,4,2,1,1,7,6,2,0,0,2,3,5,7,-1,3.5,1.833333333,1.5,2.5,1.666666667,1.75,1.5,40.625,18.75,40.625,22,27.3,0.5,Malaysia-Super,2022/05/06,2022/05/10 13:15
6,Ku Lumpur,6,2,1,3,10,11,4,2,1,1,7,6,2,0,0,2,3,5,7,-1,3.5,1.833333333,1.5,2.5,1.666666667,1.75,1.5,40.625,18.75,40.625,22,27.3,0.5,Malaysia-Super,2022/05/06,2022/04/24 15:00
7,Petaling JaR,6,2,1,3,8,10,3,2,0,1,5,3,3,0,1,2,3,7,7,-2,3,1.666666667,1,2.333333333,1.333333333,1.666666667,1,40.625,18.75,40.625,22,27.3,0.583333333,Malaysia-Super,2022/05/06,2022/04/23 15:00
7,Petaling JaR,6,2,1,3,8,10,3,2,0,1,5,3,3,0,1,2,3,7,7,-2,3,1.666666667,1,2.333333333,1.333333333,1.666666667,1,40.625,18.75,40.625,22,27.3,0.583333333,Malaysia-Super,2022/05/06,2022/05/10 14:00
7,Petaling JaR,6,2,1,3,8,10,3,2,0,1,5,3,3,0,1,2,3,7,7,-2,3,1.666666667,1,2.333333333,1.333333333,1.666666667,1,40.625,18.75,40.625,22,27.3,0.583333333,Malaysia-Super,2022/05/06,2022/05/06 14:00
8,Terengganu,4,2,0,2,5,5,1,1,0,0,2,0,3,1,0,2,3,5,6,0,2.5,1.25,0,1.666666667,1.25,2,1,40.625,18.75,40.625,22,18.2,0.666666667,Malaysia-Super,2022/05/06,2022/04/22 15:00
8,Terengganu,4,2,0,2,5,5,1,1,0,0,2,0,3,1,0,2,3,5,6,0,2.5,1.25,0,1.666666667,1.25,2,1,40.625,18.75,40.625,22,18.2,0.666666667,Malaysia-Super,2022/05/06,2022/05/07 14:00
9,Pahang,5,1,1,3,6,8,3,1,1,1,5,4,2,0,0,2,1,4,4,-2,2.8,1.6,1.333333333,2,1.2,1.666666667,0.5,40.625,18.75,40.625,22,22.7,0.75,Malaysia-Super,2022/05/06,2022/04/23 15:00
9,Pahang,5,1,1,3,6,8,3,1,1,1,5,4,2,0,0,2,1,4,4,-2,2.8,1.6,1.333333333,2,1.2,1.666666667,0.5,40.625,18.75,40.625,22,22.7,0.75,Malaysia-Super,2022/05/06,2022/04/29 15:00
9,Pahang,5,1,1,3,6,8,3,1,1,1,5,4,2,0,0,2,1,4,4,-2,2.8,1.6,1.333333333,2,1.2,1.666666667,0.5,40.625,18.75,40.625,22,22.7,0.75,Malaysia-Super,2022/05/06,2022/05/07 13:15
10,Malacca,5,1,1,3,3,6,1,0,0,1,0,1,4,1,1,2,3,5,4,-3,1.8,1.2,1,1.25,0.6,0,0.75,40.625,18.75,40.625,22,22.7,0.833333333,Malaysia-Super,2022/05/06,2022/05/10 13:15
10,Malacca,5,1,1,3,3,6,1,0,0,1,0,1,4,1,1,2,3,5,4,-3,1.8,1.2,1,1.25,0.6,0,0.75,40.625,18.75,40.625,22,22.7,0.833333333,Malaysia-Super,2022/05/06,2022/05/06 14:00
11,Sarawak Utd,6,1,1,4,4,12,4,0,1,3,1,5,2,1,0,1,3,7,4,-8,2.67,2,1.25,3.5,0.666666667,0.25,1.5,40.625,18.75,40.625,22,27.3,0.916666667,Malaysia-Super,2022/05/06,2022/05/06 13:15
11,Sarawak Utd,6,1,1,4,4,12,4,0,1,3,1,5,2,1,0,1,3,7,4,-8,2.67,2,1.25,3.5,0.666666667,0.25,1.5,40.625,18.75,40.625,22,27.3,0.916666667,Malaysia-Super,2022/05/06,2022/04/23 15:00
12,Pulau Pinang,6,0,3,3,5,9,3,0,2,1,3,4,3,0,1,2,2,5,3,-4,2.33,1.5,1.333333333,1.666666667,0.833333333,1,0.666666667,40.625,18.75,40.625,22,27.3,1,Malaysia-Super,2022/05/06,2022/05/07 14:00
12,Pulau Pinang,6,0,3,3,5,9,3,0,2,1,3,4,3,0,1,2,2,5,3,-4,2.33,1.5,1.333333333,1.666666667,0.833333333,1,0.666666667,40.625,18.75,40.625,22,27.3,1,Malaysia-Super,2022/05/06,2022/04/23 15:00
12,Pulau Pinang,6,0,3,3,5,9,3,0,2,1,3,4,3,0,1,2,2,5,3,-4,2.33,1.5,1.333333333,1.666666667,0.833333333,1,0.666666667,40.625,18.75,40.625,22,27.3,1,Malaysia-Super,2022/05/06,2022/05/10 13:15
1,Djoliba,21,10,8,3,27,10,11,5,5,1,17,7,10,5,3,2,10,3,38,17,1.76,0.476190476,0.636363636,0.3,1.285714286,1.545454545,1,29.14438503,41.71122995,29.14438503,34,61.8,0.055555556,Mali-Premiere,2022/05/06,2022/04/29 18:00
1,Djoliba,21,10,8,3,27,10,11,5,5,1,17,7,10,5,3,2,10,3,38,17,1.76,0.476190476,0.636363636,0.3,1.285714286,1.545454545,1,29.14438503,41.71122995,29.14438503,34,61.8,0.055555556,Mali-Premiere,2022/05/06,2022/05/04 18:00
1,Djoliba,21,10,8,3,27,10,11,5,5,1,17,7,10,5,3,2,10,3,38,17,1.76,0.476190476,0.636363636,0.3,1.285714286,1.545454545,1,29.14438503,41.71122995,29.14438503,34,61.8,0.055555556,Mali-Premiere,2022/05/06,2022/05/07 17:00
2,Bakaridjan,21,9,8,4,20,13,11,6,3,2,11,5,10,3,5,2,9,8,35,7,1.57,0.619047619,0.454545455,0.8,0.952380952,1,0.9,29.14438503,41.71122995,29.14438503,34,61.8,0.111111111,Mali-Premiere,2022/05/06,2022/04/28 17:00
2,Bakaridjan,21,9,8,4,20,13,11,6,3,2,11,5,10,3,5,2,9,8,35,7,1.57,0.619047619,0.454545455,0.8,0.952380952,1,0.9,29.14438503,41.71122995,29.14438503,34,61.8,0.111111111,Mali-Premiere,2022/05/06,2022/05/08 18:00
3,USC Kita,21,8,11,2,25,20,10,5,4,1,14,10,11,3,7,1,11,10,35,5,2.14,0.952380952,1,0.909090909,1.19047619,1.4,1,29.14438503,41.71122995,29.14438503,34,61.8,0.166666667,Mali-Premiere,2022/05/06,2022/05/07 17:00
3,USC Kita,21,8,11,2,25,20,10,5,4,1,14,10,11,3,7,1,11,10,35,5,2.14,0.952380952,1,0.909090909,1.19047619,1.4,1,29.14438503,41.71122995,29.14438503,34,61.8,0.166666667,Mali-Premiere,2022/05/06,2022/04/29 20:00
4,Onze Creatur,21,6,13,2,20,11,10,4,6,0,13,5,11,2,7,2,7,6,31,9,1.48,0.523809524,0.5,0.545454545,0.952380952,1.3,0.636363636,29.14438503,41.71122995,29.14438503,34,61.8,0.222222222,Mali-Premiere,2022/05/06,2022/05/08 18:00
5,Korofina,20,8,7,5,19,14,10,3,3,4,9,10,10,5,4,1,10,4,31,5,1.65,0.7,1,0.4,0.95,0.9,1,29.14438503,41.71122995,29.14438503,34,58.8,0.277777778,Mali-Premiere,2022/05/06,2022/05/08 18:00
6,CO Bamako,21,8,7,6,18,15,10,3,4,3,4,5,11,5,3,3,14,10,31,3,1.57,0.714285714,0.5,0.909090909,0.857142857,0.4,1.272727273,29.14438503,41.71122995,29.14438503,34,61.8,0.333333333,Mali-Premiere,2022/05/06,2022/05/07 20:00
7,Stade Malien,21,8,6,7,22,14,10,4,4,2,10,5,11,4,2,5,12,9,30,8,1.71,0.666666667,0.5,0.818181818,1.047619048,1,1.090909091,29.14438503,41.71122995,29.14438503,34,61.8,0.388888889,Mali-Premiere,2022/05/06,2022/05/07 18:00
7,Stade Malien,21,8,6,7,22,14,10,4,4,2,10,5,11,4,2,5,12,9,30,8,1.71,0.666666667,0.5,0.818181818,1.047619048,1,1.090909091,29.14438503,41.71122995,29.14438503,34,61.8,0.388888889,Mali-Premiere,2022/05/06,2022/04/28 18:00
8,Yeelen,21,6,10,5,19,19,11,3,6,2,6,6,10,3,4,3,13,13,28,0,1.81,0.904761905,0.545454545,1.3,0.904761905,0.545454545,1.3,29.14438503,41.71122995,29.14438503,34,61.8,0.444444444,Mali-Premiere,2022/05/06,2022/05/07 20:00
8,Yeelen,21,6,10,5,19,19,11,3,6,2,6,6,10,3,4,3,13,13,28,0,1.81,0.904761905,0.545454545,1.3,0.904761905,0.545454545,1.3,29.14438503,41.71122995,29.14438503,34,61.8,0.444444444,Mali-Premiere,2022/05/06,2022/04/29 18:00
9,LC Bamako,21,6,8,7,23,20,10,3,3,4,8,9,11,3,5,3,15,11,26,3,2.05,0.952380952,0.9,1,1.095238095,0.8,1.363636364,29.14438503,41.71122995,29.14438503,34,61.8,0.5,Mali-Premiere,2022/05/06,2022/05/07 18:00
9,LC Bamako,21,6,8,7,23,20,10,3,3,4,8,9,11,3,5,3,15,11,26,3,2.05,0.952380952,0.9,1,1.095238095,0.8,1.363636364,29.14438503,41.71122995,29.14438503,34,61.8,0.5,Mali-Premiere,2022/05/06,2022/04/28 17:00
10,Blk Stars Ml,21,8,2,11,15,21,11,5,2,4,9,9,10,3,0,7,6,12,26,-6,1.71,1,0.818181818,1.2,0.714285714,0.818181818,0.6,29.14438503,41.71122995,29.14438503,34,61.8,0.555555556,Mali-Premiere,2022/05/06,2022/05/08 20:00
11,Police Mali,20,5,10,5,16,18,10,2,6,2,9,10,10,3,4,3,7,8,25,-2,1.7,0.9,1,0.8,0.8,0.9,0.7,29.14438503,41.71122995,29.14438503,34,58.8,0.611111111,Mali-Premiere,2022/05/06,2022/05/07 17:00
12,Foot Elite,20,5,9,6,18,20,10,3,2,5,9,11,10,2,7,1,9,9,24,-2,1.9,1,1.1,0.9,0.9,0.9,0.9,29.14438503,41.71122995,29.14438503,34,58.8,0.666666667,Mali-Premiere,2022/05/06,2022/05/06 18:00
13,Bougouba Ma,21,6,6,9,20,24,10,3,4,3,12,13,11,3,2,6,8,11,24,-4,2.1,1.142857143,1.3,1,0.952380952,1.2,0.727272727,29.14438503,41.71122995,29.14438503,34,61.8,0.722222222,Mali-Premiere,2022/05/06,2022/05/07 17:00
14,USFAS Bamako,21,4,11,6,14,20,11,3,4,4,10,14,10,1,7,2,4,6,23,-6,1.62,0.952380952,1.272727273,0.6,0.666666667,0.909090909,0.4,29.14438503,41.71122995,29.14438503,34,61.8,0.777777778,Mali-Premiere,2022/05/06,2022/04/29 20:00
14,USFAS Bamako,21,4,11,6,14,20,11,3,4,4,10,14,10,1,7,2,4,6,23,-6,1.62,0.952380952,1.272727273,0.6,0.666666667,0.909090909,0.4,29.14438503,41.71122995,29.14438503,34,61.8,0.777777778,Mali-Premiere,2022/05/06,2022/05/04 18:00
14,USFAS Bamako,21,4,11,6,14,20,11,3,4,4,10,14,10,1,7,2,4,6,23,-6,1.62,0.952380952,1.272727273,0.6,0.666666667,0.909090909,0.4,29.14438503,41.71122995,29.14438503,34,61.8,0.777777778,Mali-Premiere,2022/05/06,2022/05/07 18:00
15,Real Bamako,20,4,10,6,8,10,9,3,4,2,5,4,11,1,6,4,3,6,22,-2,0.9,0.5,0.444444444,0.545454545,0.4,0.555555556,0.272727273,29.14438503,41.71122995,29.14438503,34,58.8,0.833333333,Mali-Premiere,2022/05/06,2022/05/08 20:00
15,Real Bamako,20,4,10,6,8,10,9,3,4,2,5,4,11,1,6,4,3,6,22,-2,0.9,0.5,0.444444444,0.545454545,0.4,0.555555556,0.272727273,29.14438503,41.71122995,29.14438503,34,58.8,0.833333333,Mali-Premiere,2022/05/06,2022/04/28 17:00
16,CSD,21,4,10,7,15,21,11,3,5,3,7,10,10,1,5,4,8,11,22,-6,1.71,1,0.909090909,1.1,0.714285714,0.636363636,0.8,29.14438503,41.71122995,29.14438503,34,61.8,0.888888889,Mali-Premiere,2022/05/06,2022/05/07 18:00
17,Douanes Sik,21,2,10,9,10,22,11,1,7,3,6,11,10,1,3,6,4,11,16,-12,1.52,1.047619048,1,1.1,0.476190476,0.545454545,0.4,29.14438503,41.71122995,29.14438503,34,61.8,0.944444444,Mali-Premiere,2022/05/06,2022/04/28 17:00
17,Douanes Sik,21,2,10,9,10,22,11,1,7,3,6,11,10,1,3,6,4,11,16,-12,1.52,1.047619048,1,1.1,0.476190476,0.545454545,0.4,29.14438503,41.71122995,29.14438503,34,61.8,0.944444444,Mali-Premiere,2022/05/06,2022/05/08 18:00
18,ASOM,21,2,10,9,10,27,11,2,6,3,7,9,10,0,4,6,3,18,16,-17,1.76,1.285714286,0.818181818,1.8,0.476190476,0.636363636,0.3,29.14438503,41.71122995,29.14438503,34,61.8,1,Mali-Premiere,2022/05/06,2022/04/28 18:00
18,ASOM,21,2,10,9,10,27,11,2,6,3,7,9,10,0,4,6,3,18,16,-17,1.76,1.285714286,0.818181818,1.8,0.476190476,0.636363636,0.3,29.14438503,41.71122995,29.14438503,34,61.8,1,Mali-Premiere,2022/05/06,2022/05/06 18:00
1,Wydad Cas,22,15,4,3,35,16,11,9,1,1,20,8,11,6,3,2,15,8,49,19,2.32,0.727272727,0.727272727,0.727272727,1.590909091,1.818181818,1.363636364,33.80681818,32.38636364,33.80681818,30,73.3,0.0625,Morocco-GNF-1,2022/05/06,2022/04/29 23:00
1,Wydad Cas,22,15,4,3,35,16,11,9,1,1,20,8,11,6,3,2,15,8,49,19,2.32,0.727272727,0.727272727,0.727272727,1.590909091,1.818181818,1.363636364,33.80681818,32.38636364,33.80681818,30,73.3,0.0625,Morocco-GNF-1,2022/05/06,2022/04/26 23:00
2,Raja Casabl,22,13,7,2,30,14,11,6,4,1,15,7,11,7,3,1,15,7,46,16,2,0.636363636,0.636363636,0.636363636,1.363636364,1.363636364,1.363636364,33.80681818,32.38636364,33.80681818,30,73.3,0.125,Morocco-GNF-1,2022/05/06,2022/04/25 23:00
2,Raja Casabl,22,13,7,2,30,14,11,6,4,1,15,7,11,7,3,1,15,7,46,16,2,0.636363636,0.636363636,0.636363636,1.363636364,1.363636364,1.363636364,33.80681818,32.38636364,33.80681818,30,73.3,0.125,Morocco-GNF-1,2022/05/06,2022/05/06 21:30
2,Raja Casabl,22,13,7,2,30,14,11,6,4,1,15,7,11,7,3,1,15,7,46,16,2,0.636363636,0.636363636,0.636363636,1.363636364,1.363636364,1.363636364,33.80681818,32.38636364,33.80681818,30,73.3,0.125,Morocco-GNF-1,2022/05/06,2022/04/28 23:00
3,Maghreb Fs,22,6,13,3,18,12,11,5,6,0,13,4,11,1,7,3,5,8,31,6,1.36,0.545454545,0.363636364,0.727272727,0.818181818,1.181818182,0.454545455,33.80681818,32.38636364,33.80681818,30,73.3,0.1875,Morocco-GNF-1,2022/05/06,2022/04/24 23:00
4,RSB Berkane,22,7,10,5,26,22,12,6,4,2,21,13,10,1,6,3,5,9,31,4,2.18,1,1.083333333,0.9,1.181818182,1.75,0.5,33.80681818,32.38636364,33.80681818,30,73.3,0.25,Morocco-GNF-1,2022/05/06,2022/04/30 23:00
4,RSB Berkane,22,7,10,5,26,22,12,6,4,2,21,13,10,1,6,3,5,9,31,4,2.18,1,1.083333333,0.9,1.181818182,1.75,0.5,33.80681818,32.38636364,33.80681818,30,73.3,0.25,Morocco-GNF-1,2022/05/06,2022/04/27 23:00
5,FAR Rabat,22,8,7,7,27,25,11,4,4,3,14,14,11,4,3,4,13,11,31,2,2.36,1.136363636,1.272727273,1,1.227272727,1.272727273,1.181818182,33.80681818,32.38636364,33.80681818,30,73.3,0.3125,Morocco-GNF-1,2022/05/06,2022/05/07 17:00
5,FAR Rabat,22,8,7,7,27,25,11,4,4,3,14,14,11,4,3,4,13,11,31,2,2.36,1.136363636,1.272727273,1,1.227272727,1.272727273,1.181818182,33.80681818,32.38636364,33.80681818,30,73.3,0.3125,Morocco-GNF-1,2022/05/06,2022/04/29 23:00
6,Khouribga,22,7,9,6,28,28,11,3,7,1,12,12,11,4,2,5,16,16,30,0,2.55,1.272727273,1.090909091,1.454545455,1.272727273,1.090909091,1.454545455,33.80681818,32.38636364,33.80681818,30,73.3,0.375,Morocco-GNF-1,2022/05/06,2022/04/27 23:00
6,Khouribga,22,7,9,6,28,28,11,3,7,1,12,12,11,4,2,5,16,16,30,0,2.55,1.272727273,1.090909091,1.454545455,1.272727273,1.090909091,1.454545455,33.80681818,32.38636364,33.80681818,30,73.3,0.375,Morocco-GNF-1,2022/05/06,2022/05/08 19:15
6,Khouribga,22,7,9,6,28,28,11,3,7,1,12,12,11,4,2,5,16,16,30,0,2.55,1.272727273,1.090909091,1.454545455,1.272727273,1.090909091,1.454545455,33.80681818,32.38636364,33.80681818,30,73.3,0.375,Morocco-GNF-1,2022/05/06,2022/04/24 23:00
7,Dif El Jad,22,7,9,6,24,28,11,5,5,1,11,7,11,2,4,5,13,21,30,-4,2.36,1.272727273,0.636363636,1.909090909,1.090909091,1,1.181818182,33.80681818,32.38636364,33.80681818,30,73.3,0.4375,Morocco-GNF-1,2022/05/06,2022/04/24 23:00
7,Dif El Jad,22,7,9,6,24,28,11,5,5,1,11,7,11,2,4,5,13,21,30,-4,2.36,1.272727273,0.636363636,1.909090909,1.090909091,1,1.181818182,33.80681818,32.38636364,33.80681818,30,73.3,0.4375,Morocco-GNF-1,2022/05/06,2022/05/06 21:30
8,Chabab Mohamme,22,7,8,7,23,18,11,7,2,2,18,6,11,0,6,5,5,12,29,5,1.86,0.818181818,0.545454545,1.090909091,1.045454545,1.636363636,0.454545455,33.80681818,32.38636364,33.80681818,30,73.3,0.5,Morocco-GNF-1,2022/05/06,2022/04/23 23:00
8,Chabab Mohamme,22,7,8,7,23,18,11,7,2,2,18,6,11,0,6,5,5,12,29,5,1.86,0.818181818,0.545454545,1.090909091,1.045454545,1.636363636,0.454545455,33.80681818,32.38636364,33.80681818,30,73.3,0.5,Morocco-GNF-1,2022/05/06,2022/05/08 17:00
9,Riadi Salmi,22,8,5,9,31,28,11,5,2,4,15,12,11,3,3,5,16,16,29,3,2.68,1.272727273,1.090909091,1.454545455,1.409090909,1.363636364,1.454545455,33.80681818,32.38636364,33.80681818,30,73.3,0.5625,Morocco-GNF-1,2022/05/06,2022/05/08 21:30
9,Riadi Salmi,22,8,5,9,31,28,11,5,2,4,15,12,11,3,3,5,16,16,29,3,2.68,1.272727273,1.090909091,1.454545455,1.409090909,1.363636364,1.454545455,33.80681818,32.38636364,33.80681818,30,73.3,0.5625,Morocco-GNF-1,2022/05/06,2022/04/30 23:00
10,Hass Agadir,22,8,5,9,17,16,10,4,2,4,9,8,12,4,3,5,8,8,29,1,1.5,0.727272727,0.8,0.666666667,0.772727273,0.9,0.666666667,33.80681818,32.38636364,33.80681818,30,73.3,0.625,Morocco-GNF-1,2022/05/06,2022/05/08 17:00
11,FUS Rabat,22,7,7,8,25,25,11,4,4,3,14,12,11,3,3,5,11,13,28,0,2.27,1.136363636,1.090909091,1.181818182,1.136363636,1.272727273,1,33.80681818,32.38636364,33.80681818,30,73.3,0.6875,Morocco-GNF-1,2022/05/06,2022/04/28 23:00
11,FUS Rabat,22,7,7,8,25,25,11,4,4,3,14,12,11,3,3,5,11,13,28,0,2.27,1.136363636,1.090909091,1.181818182,1.136363636,1.272727273,1,33.80681818,32.38636364,33.80681818,30,73.3,0.6875,Morocco-GNF-1,2022/05/06,2022/05/08 19:15
12,Ittihad Tanger,22,8,3,11,25,32,11,5,3,3,13,11,11,3,0,8,12,21,27,-7,2.59,1.454545455,1,1.909090909,1.136363636,1.181818182,1.090909091,33.80681818,32.38636364,33.80681818,30,73.3,0.75,Morocco-GNF-1,2022/05/06,
13,Olymp Safi,22,5,8,9,13,18,11,3,5,3,7,7,11,2,3,6,6,11,23,-5,1.41,0.818181818,0.636363636,1,0.590909091,0.636363636,0.545454545,33.80681818,32.38636364,33.80681818,30,73.3,0.8125,Morocco-GNF-1,2022/05/06,2022/04/26 23:00
13,Olymp Safi,22,5,8,9,13,18,11,3,5,3,7,7,11,2,3,6,6,11,23,-5,1.41,0.818181818,0.636363636,1,0.590909091,0.636363636,0.545454545,33.80681818,32.38636364,33.80681818,30,73.3,0.8125,Morocco-GNF-1,2022/05/06,2022/05/07 19:15
13,Olymp Safi,22,5,8,9,13,18,11,3,5,3,7,7,11,2,3,6,6,11,23,-5,1.41,0.818181818,0.636363636,1,0.590909091,0.636363636,0.545454545,33.80681818,32.38636364,33.80681818,30,73.3,0.8125,Morocco-GNF-1,2022/05/06,2022/04/23 23:00
14,Youss Berrec,22,5,7,10,20,31,11,4,3,4,9,10,11,1,4,6,11,21,22,-11,2.32,1.409090909,0.909090909,1.909090909,0.909090909,0.818181818,1,33.80681818,32.38636364,33.80681818,30,73.3,0.875,Morocco-GNF-1,2022/05/06,2022/05/07 19:15
15,Mouloudia Oujd,22,5,6,11,25,32,11,3,3,5,16,20,11,2,3,6,9,12,21,-7,2.59,1.454545455,1.818181818,1.090909091,1.136363636,1.454545455,0.818181818,33.80681818,32.38636364,33.80681818,30,73.3,0.9375,Morocco-GNF-1,2022/05/06,2022/04/25 23:00
15,Mouloudia Oujd,22,5,6,11,25,32,11,3,3,5,16,20,11,2,3,6,9,12,21,-7,2.59,1.454545455,1.818181818,1.090909091,1.136363636,1.454545455,0.818181818,33.80681818,32.38636364,33.80681818,30,73.3,0.9375,Morocco-GNF-1,2022/05/06,2022/05/08 21:30
16,Rap Oued Zem,22,3,6,13,9,31,11,2,2,7,3,15,11,1,4,6,6,16,15,-22,1.82,1.409090909,1.363636364,1.454545455,0.409090909,0.272727273,0.545454545,33.80681818,32.38636364,33.80681818,30,73.3,1,Morocco-GNF-1,2022/05/06,2022/04/24 23:00
16,Rap Oued Zem,22,3,6,13,9,31,11,2,2,7,3,15,11,1,4,6,6,16,15,-22,1.82,1.409090909,1.363636364,1.454545455,0.409090909,0.272727273,0.545454545,33.80681818,32.38636364,33.80681818,30,73.3,1,Morocco-GNF-1,2022/05/06,2022/05/07 17:00
1,Emmen,37,25,5,7,61,24,18,14,0,4,38,12,19,11,5,3,23,12,80,37,2.3,0.648648649,0.666666667,0.631578947,1.648648649,2.111111111,1.210526316,39.59459459,20.81081081,39.59459459,38,97.4,0.05,Netherlands-Eerste-Divisie,2022/05/06,2022/05/06 19:00
1,Emmen,37,25,5,7,61,24,18,14,0,4,38,12,19,11,5,3,23,12,80,37,2.3,0.648648649,0.666666667,0.631578947,1.648648649,2.111111111,1.210526316,39.59459459,20.81081081,39.59459459,38,97.4,0.05,Netherlands-Eerste-Divisie,2022/05/06,2022/04/29 19:00
2,Volendam,37,21,11,5,79,51,18,13,2,3,45,26,19,8,9,2,34,25,74,28,3.51,1.378378378,1.444444444,1.315789474,2.135135135,2.5,1.789473684,39.59459459,20.81081081,39.59459459,38,97.4,0.1,Netherlands-Eerste-Divisie,2022/05/06,2022/05/06 19:00
2,Volendam,37,21,11,5,79,51,18,13,2,3,45,26,19,8,9,2,34,25,74,28,3.51,1.378378378,1.444444444,1.315789474,2.135135135,2.5,1.789473684,39.59459459,20.81081081,39.59459459,38,97.4,0.1,Netherlands-Eerste-Divisie,2022/05/06,2022/04/29 19:00
3,Ado Den Haag,37,22,7,8,76,50,19,12,4,3,39,21,18,10,3,5,37,29,73,26,3.41,1.351351351,1.105263158,1.611111111,2.054054054,2.052631579,2.055555556,39.59459459,20.81081081,39.59459459,38,97.4,0.15,Netherlands-Eerste-Divisie,2022/05/06,2022/04/29 19:00
3,Ado Den Haag,37,22,7,8,76,50,19,12,4,3,39,21,18,10,3,5,37,29,73,26,3.41,1.351351351,1.105263158,1.611111111,2.054054054,2.052631579,2.055555556,39.59459459,20.81081081,39.59459459,38,97.4,0.15,Netherlands-Eerste-Divisie,2022/05/06,2022/05/06 19:00
4,Eindhoven,37,21,7,9,67,41,19,12,4,3,39,19,18,9,3,6,28,22,70,26,2.92,1.108108108,1,1.222222222,1.810810811,2.052631579,1.555555556,39.59459459,20.81081081,39.59459459,38,97.4,0.2,Netherlands-Eerste-Divisie,2022/05/06,2022/04/29 19:00
4,Eindhoven,37,21,7,9,67,41,19,12,4,3,39,19,18,9,3,6,28,22,70,26,2.92,1.108108108,1,1.222222222,1.810810811,2.052631579,1.555555556,39.59459459,20.81081081,39.59459459,38,97.4,0.2,Netherlands-Eerste-Divisie,2022/05/06,2022/05/06 19:00
5,Excelsior,37,19,8,10,80,55,18,9,4,5,42,26,19,10,4,5,38,29,65,25,3.65,1.486486486,1.444444444,1.526315789,2.162162162,2.333333333,2,39.59459459,20.81081081,39.59459459,38,97.4,0.25,Netherlands-Eerste-Divisie,2022/05/06,2022/05/06 19:00
6,Roda JC,37,17,12,8,73,47,18,9,6,3,38,21,19,8,6,5,35,26,63,26,3.24,1.27027027,1.166666667,1.368421053,1.972972973,2.111111111,1.842105263,39.59459459,20.81081081,39.59459459,38,97.4,0.3,Netherlands-Eerste-Divisie,2022/05/06,2022/05/06 19:00
6,Roda JC,37,17,12,8,73,47,18,9,6,3,38,21,19,8,6,5,35,26,63,26,3.24,1.27027027,1.166666667,1.368421053,1.972972973,2.111111111,1.842105263,39.59459459,20.81081081,39.59459459,38,97.4,0.3,Netherlands-Eerste-Divisie,2022/05/06,2022/04/29 19:00
7,Ajax 2,37,18,8,11,81,62,18,12,3,3,50,27,19,6,5,8,31,35,62,19,3.86,1.675675676,1.5,1.842105263,2.189189189,2.777777778,1.631578947,39.59459459,20.81081081,39.59459459,38,97.4,0.35,Netherlands-Eerste-Divisie,2022/05/06,2022/05/06 19:00
8,NAC Breda,37,16,10,11,58,43,19,10,7,2,33,13,18,6,3,9,25,30,58,15,2.73,1.162162162,0.684210526,1.666666667,1.567567568,1.736842105,1.388888889,39.59459459,20.81081081,39.59459459,38,97.4,0.4,Netherlands-Eerste-Divisie,2022/05/06,2022/04/29 19:00
8,NAC Breda,37,16,10,11,58,43,19,10,7,2,33,13,18,6,3,9,25,30,58,15,2.73,1.162162162,0.684210526,1.666666667,1.567567568,1.736842105,1.388888889,39.59459459,20.81081081,39.59459459,38,97.4,0.4,Netherlands-Eerste-Divisie,2022/05/06,2022/05/06 19:00
9,De Graafschap,37,15,10,12,51,42,19,4,8,7,18,25,18,11,2,5,33,17,55,9,2.51,1.135135135,1.315789474,0.944444444,1.378378378,0.947368421,1.833333333,39.59459459,20.81081081,39.59459459,38,97.4,0.45,Netherlands-Eerste-Divisie,2022/05/06,2022/05/06 19:00
10,FC Den Bosch,37,14,4,19,41,60,19,10,1,8,23,27,18,4,3,11,18,33,46,-19,2.73,1.621621622,1.421052632,1.833333333,1.108108108,1.210526316,1,39.59459459,20.81081081,39.59459459,38,97.4,0.5,Netherlands-Eerste-Divisie,2022/05/06,2022/04/29 19:00
10,FC Den Bosch,37,14,4,19,41,60,19,10,1,8,23,27,18,4,3,11,18,33,46,-19,2.73,1.621621622,1.421052632,1.833333333,1.108108108,1.210526316,1,39.59459459,20.81081081,39.59459459,38,97.4,0.5,Netherlands-Eerste-Divisie,2022/05/06,2022/05/06 19:00
11,VVV Venlo,37,13,6,18,47,62,19,7,4,8,27,33,18,6,2,10,20,29,45,-15,2.95,1.675675676,1.736842105,1.611111111,1.27027027,1.421052632,1.111111111,39.59459459,20.81081081,39.59459459,38,97.4,0.55,Netherlands-Eerste-Divisie,2022/05/06,2022/05/06 19:00
12,Jong PSV,37,11,10,16,60,62,18,7,5,6,34,27,19,4,5,10,26,35,43,-2,3.3,1.675675676,1.5,1.842105263,1.621621622,1.888888889,1.368421053,39.59459459,20.81081081,39.59459459,38,97.4,0.6,Netherlands-Eerste-Divisie,2022/05/06,2022/05/06 19:00
13,Almere City,37,11,8,18,57,66,18,5,4,9,26,29,19,6,4,9,31,37,41,-9,3.32,1.783783784,1.611111111,1.947368421,1.540540541,1.444444444,1.631578947,39.59459459,20.81081081,39.59459459,38,97.4,0.65,Netherlands-Eerste-Divisie,2022/05/06,2022/05/06 19:00
13,Almere City,37,11,8,18,57,66,18,5,4,9,26,29,19,6,4,9,31,37,41,-9,3.32,1.783783784,1.611111111,1.947368421,1.540540541,1.444444444,1.631578947,39.59459459,20.81081081,39.59459459,38,97.4,0.65,Netherlands-Eerste-Divisie,2022/05/06,2022/04/29 19:00
14,TOP Oss,37,11,8,18,48,61,18,6,5,7,28,27,19,5,3,11,20,34,41,-13,2.95,1.648648649,1.5,1.789473684,1.297297297,1.555555556,1.052631579,39.59459459,20.81081081,39.59459459,38,97.4,0.7,Netherlands-Eerste-Divisie,2022/05/06,2022/05/06 19:00
14,TOP Oss,37,11,8,18,48,61,18,6,5,7,28,27,19,5,3,11,20,34,41,-13,2.95,1.648648649,1.5,1.789473684,1.297297297,1.555555556,1.052631579,39.59459459,20.81081081,39.59459459,38,97.4,0.7,Netherlands-Eerste-Divisie,2022/05/06,2022/04/29 19:00
15,Jong AZ,37,11,6,20,36,50,19,7,3,9,19,22,18,4,3,11,17,28,39,-14,2.32,1.351351351,1.157894737,1.555555556,0.972972973,1,0.944444444,39.59459459,20.81081081,39.59459459,38,97.4,0.75,Netherlands-Eerste-Divisie,2022/05/06,2022/05/06 19:00
16,Jong Utrecht,37,11,5,21,41,64,18,5,0,13,14,32,19,6,5,8,27,32,38,-23,2.84,1.72972973,1.777777778,1.684210526,1.108108108,0.777777778,1.421052632,39.59459459,20.81081081,39.59459459,38,97.4,0.8,Netherlands-Eerste-Divisie,2022/05/06,2022/05/06 19:00
17,Dordrecht,37,10,8,19,52,76,19,6,6,7,28,31,18,4,2,12,24,45,38,-24,3.46,2.054054054,1.631578947,2.5,1.405405405,1.473684211,1.333333333,39.59459459,20.81081081,39.59459459,38,97.4,0.85,Netherlands-Eerste-Divisie,2022/05/06,2022/04/29 19:00
17,Dordrecht,37,10,8,19,52,76,19,6,6,7,28,31,18,4,2,12,24,45,38,-24,3.46,2.054054054,1.631578947,2.5,1.405405405,1.473684211,1.333333333,39.59459459,20.81081081,39.59459459,38,97.4,0.85,Netherlands-Eerste-Divisie,2022/05/06,2022/05/06 19:00
18,MVV,37,11,4,22,42,75,19,5,3,11,22,37,18,6,1,11,20,38,37,-33,3.16,2.027027027,1.947368421,2.111111111,1.135135135,1.157894737,1.111111111,39.59459459,20.81081081,39.59459459,38,97.4,0.9,Netherlands-Eerste-Divisie,2022/05/06,2022/05/06 19:00
19,Telstar,37,8,11,18,44,70,19,4,5,10,21,39,18,4,6,8,23,31,35,-26,3.08,1.891891892,2.052631579,1.722222222,1.189189189,1.105263158,1.277777778,39.59459459,20.81081081,39.59459459,38,97.4,0.95,Netherlands-Eerste-Divisie,2022/05/06,2022/05/06 19:00
20,Helmond,37,8,6,23,38,71,18,4,3,11,19,35,19,4,3,12,19,36,30,-33,2.95,1.918918919,1.944444444,1.894736842,1.027027027,1.055555556,1,39.59459459,20.81081081,39.59459459,38,97.4,1,Netherlands-Eerste-Divisie,2022/05/06,2022/05/06 19:00
1,Al Seeb,23,15,5,3,48,16,11,8,1,2,26,7,12,7,4,1,22,9,50,32,2.78,0.695652174,0.636363636,0.75,2.086956522,2.363636364,1.833333333,34.375,31.25,34.375,26,88.5,0.071428571,Oman-Elite-League,2022/05/06,2022/05/10 16:05
1,Al Seeb,23,15,5,3,48,16,11,8,1,2,26,7,12,7,4,1,22,9,50,32,2.78,0.695652174,0.636363636,0.75,2.086956522,2.363636364,1.833333333,34.375,31.25,34.375,26,88.5,0.071428571,Oman-Elite-League,2022/05/06,2022/05/06 16:10
2,Al Nahda,23,13,7,3,31,16,13,8,4,1,23,8,10,5,3,2,8,8,46,15,2.04,0.695652174,0.615384615,0.8,1.347826087,1.769230769,0.8,34.375,31.25,34.375,26,88.5,0.142857143,Oman-Elite-League,2022/05/06,2022/05/10 16:05
2,Al Nahda,23,13,7,3,31,16,13,8,4,1,23,8,10,5,3,2,8,8,46,15,2.04,0.695652174,0.615384615,0.8,1.347826087,1.769230769,0.8,34.375,31.25,34.375,26,88.5,0.142857143,Oman-Elite-League,2022/05/06,2022/05/06 16:10
3,Dhufar,23,12,8,3,37,15,12,7,4,1,28,9,11,5,4,2,9,6,44,22,2.26,0.652173913,0.75,0.545454545,1.608695652,2.333333333,0.818181818,34.375,31.25,34.375,26,88.5,0.214285714,Oman-Elite-League,2022/05/06,2022/05/10 16:05
3,Dhufar,23,12,8,3,37,15,12,7,4,1,28,9,11,5,4,2,9,6,44,22,2.26,0.652173913,0.75,0.545454545,1.608695652,2.333333333,0.818181818,34.375,31.25,34.375,26,88.5,0.214285714,Oman-Elite-League,2022/05/06,2022/05/06 16:10
4,Al Msnaa,23,12,5,6,31,21,12,6,3,3,19,12,11,6,2,3,12,9,41,10,2.26,0.913043478,1,0.818181818,1.347826087,1.583333333,1.090909091,34.375,31.25,34.375,26,88.5,0.285714286,Oman-Elite-League,2022/05/06,2022/04/29 19:15
4,Al Msnaa,23,12,5,6,31,21,12,6,3,3,19,12,11,6,2,3,12,9,41,10,2.26,0.913043478,1,0.818181818,1.347826087,1.583333333,1.090909091,34.375,31.25,34.375,26,88.5,0.285714286,Oman-Elite-League,2022/05/06,2022/05/06 16:10
4,Al Msnaa,23,12,5,6,31,21,12,6,3,3,19,12,11,6,2,3,12,9,41,10,2.26,0.913043478,1,0.818181818,1.347826087,1.583333333,1.090909091,34.375,31.25,34.375,26,88.5,0.285714286,Oman-Elite-League,2022/05/06,2022/05/10 16:05
5,Al Nasr Om,23,10,8,5,26,20,11,5,5,1,14,8,12,5,3,4,12,12,38,6,2,0.869565217,0.727272727,1,1.130434783,1.272727273,1,34.375,31.25,34.375,26,88.5,0.357142857,Oman-Elite-League,2022/05/06,2022/05/06 16:10
5,Al Nasr Om,23,10,8,5,26,20,11,5,5,1,14,8,12,5,3,4,12,12,38,6,2,0.869565217,0.727272727,1,1.130434783,1.272727273,1,34.375,31.25,34.375,26,88.5,0.357142857,Oman-Elite-League,2022/05/06,2022/05/10 16:05
6,Oman FC,23,8,7,8,29,27,11,4,3,4,13,8,12,4,4,4,16,19,31,2,2.43,1.173913043,0.727272727,1.583333333,1.260869565,1.181818182,1.333333333,34.375,31.25,34.375,26,88.5,0.428571429,Oman-Elite-League,2022/05/06,2022/05/06 16:10
6,Oman FC,23,8,7,8,29,27,11,4,3,4,13,8,12,4,4,4,16,19,31,2,2.43,1.173913043,0.727272727,1.583333333,1.260869565,1.181818182,1.333333333,34.375,31.25,34.375,26,88.5,0.428571429,Oman-Elite-League,2022/05/06,2022/05/10 16:05
7,Al Rustaq,23,8,7,8,23,22,11,4,4,3,11,7,12,4,3,5,12,15,31,1,1.96,0.956521739,0.636363636,1.25,1,1,1,34.375,31.25,34.375,26,88.5,0.5,Oman-Elite-League,2022/05/06,2022/05/06 16:10
7,Al Rustaq,23,8,7,8,23,22,11,4,4,3,11,7,12,4,3,5,12,15,31,1,1.96,0.956521739,0.636363636,1.25,1,1,1,34.375,31.25,34.375,26,88.5,0.5,Oman-Elite-League,2022/05/06,2022/04/29 19:15
7,Al Rustaq,23,8,7,8,23,22,11,4,4,3,11,7,12,4,3,5,12,15,31,1,1.96,0.956521739,0.636363636,1.25,1,1,1,34.375,31.25,34.375,26,88.5,0.5,Oman-Elite-League,2022/05/06,2022/05/10 16:05
8,Sohar,23,7,9,7,23,28,12,4,5,3,13,10,11,3,4,4,10,18,30,-5,2.22,1.217391304,0.833333333,1.636363636,1,1.083333333,0.909090909,34.375,31.25,34.375,26,88.5,0.571428571,Oman-Elite-League,2022/05/06,2022/05/06 16:10
8,Sohar,23,7,9,7,23,28,12,4,5,3,13,10,11,3,4,4,10,18,30,-5,2.22,1.217391304,0.833333333,1.636363636,1,1.083333333,0.909090909,34.375,31.25,34.375,26,88.5,0.571428571,Oman-Elite-League,2022/05/06,2022/05/10 16:05
9,Al Suwaiq,22,6,7,9,21,25,11,3,4,4,10,13,11,3,3,5,11,12,25,-4,2.09,1.136363636,1.181818182,1.090909091,0.954545455,0.909090909,1,34.375,31.25,34.375,26,84.6,0.642857143,Oman-Elite-League,2022/05/06,2022/05/06 16:10
9,Al Suwaiq,22,6,7,9,21,25,11,3,4,4,10,13,11,3,3,5,11,12,25,-4,2.09,1.136363636,1.181818182,1.090909091,0.954545455,0.909090909,1,34.375,31.25,34.375,26,84.6,0.642857143,Oman-Elite-League,2022/05/06,2022/05/10 16:05
10,Bahla,23,4,8,11,24,33,11,2,3,6,12,17,12,2,5,5,12,16,20,-9,2.48,1.434782609,1.545454545,1.333333333,1.043478261,1.090909091,1,34.375,31.25,34.375,26,88.5,0.714285714,Oman-Elite-League,2022/05/06,2022/05/06 16:10
10,Bahla,23,4,8,11,24,33,11,2,3,6,12,17,12,2,5,5,12,16,20,-9,2.48,1.434782609,1.545454545,1.333333333,1.043478261,1.090909091,1,34.375,31.25,34.375,26,88.5,0.714285714,Oman-Elite-League,2022/05/06,2022/05/10 16:05
11,Al Ittihad Om,23,4,8,11,17,37,10,1,3,6,6,16,13,3,5,5,11,21,20,-20,2.35,1.608695652,1.6,1.615384615,0.739130435,0.6,0.846153846,34.375,31.25,34.375,26,88.5,0.785714286,Oman-Elite-League,2022/05/06,2022/05/06 16:10
11,Al Ittihad Om,23,4,8,11,17,37,10,1,3,6,6,16,13,3,5,5,11,21,20,-20,2.35,1.608695652,1.6,1.615384615,0.739130435,0.6,0.846153846,34.375,31.25,34.375,26,88.5,0.785714286,Oman-Elite-League,2022/05/06,2022/05/10 16:05
12,Muscat,22,5,4,13,19,30,11,3,0,8,12,17,11,2,4,5,7,13,19,-11,2.23,1.363636364,1.545454545,1.181818182,0.863636364,1.090909091,0.636363636,34.375,31.25,34.375,26,84.6,0.857142857,Oman-Elite-League,2022/05/06,2022/05/10 16:05
12,Muscat,22,5,4,13,19,30,11,3,0,8,12,17,11,2,4,5,7,13,19,-11,2.23,1.363636364,1.545454545,1.181818182,0.863636364,1.090909091,0.636363636,34.375,31.25,34.375,26,84.6,0.857142857,Oman-Elite-League,2022/05/06,2022/05/06 16:10
13,Nizwa,23,4,7,12,10,32,12,3,3,6,7,13,11,1,4,6,3,19,19,-22,1.83,1.391304348,1.083333333,1.727272727,0.434782609,0.583333333,0.272727273,34.375,31.25,34.375,26,88.5,0.928571429,Oman-Elite-League,2022/05/06,2022/05/10 16:05
13,Nizwa,23,4,7,12,10,32,12,3,3,6,7,13,11,1,4,6,3,19,19,-22,1.83,1.391304348,1.083333333,1.727272727,0.434782609,0.583333333,0.272727273,34.375,31.25,34.375,26,88.5,0.928571429,Oman-Elite-League,2022/05/06,2022/05/06 16:10
14,Saham,23,2,10,11,16,33,12,1,8,3,7,9,11,1,2,8,9,24,16,-17,2.13,1.434782609,0.75,2.181818182,0.695652174,0.583333333,0.818181818,34.375,31.25,34.375,26,88.5,1,Oman-Elite-League,2022/05/06,2022/05/10 16:05
14,Saham,23,2,10,11,16,33,12,1,8,3,7,9,11,1,2,8,9,24,16,-17,2.13,1.434782609,0.75,2.181818182,0.695652174,0.583333333,0.818181818,34.375,31.25,34.375,26,88.5,1,Oman-Elite-League,2022/05/06,2022/05/06 16:10
1,Lech Poznan,31,19,8,4,61,21,16,12,3,1,38,6,15,7,5,3,23,15,65,40,2.65,0.677419355,0.375,1,1.967741935,2.375,1.533333333,36.55913978,26.88172043,36.55913978,34,91.2,0.055555556,Poland-Ekstraklasa,2022/05/06,2022/05/08 16:30
2,Rakow,31,19,8,4,56,28,15,9,5,1,31,12,16,10,3,3,25,16,65,28,2.71,0.903225806,0.8,1,1.806451613,2.066666667,1.5625,36.55913978,26.88172043,36.55913978,34,91.2,0.111111111,Poland-Ekstraklasa,2022/05/06,2022/05/08 14:00
3,Pogon,31,18,8,5,60,28,16,11,2,3,39,17,15,7,6,2,21,11,62,32,2.84,0.903225806,1.0625,0.733333333,1.935483871,2.4375,1.4,36.55913978,26.88172043,36.55913978,34,91.2,0.166666667,Poland-Ekstraklasa,2022/05/06,2022/05/07 16:30
4,Lechia Gdansk,31,15,8,8,49,34,15,11,3,1,27,9,16,4,5,7,22,25,53,15,2.68,1.096774194,0.6,1.5625,1.580645161,1.8,1.375,36.55913978,26.88172043,36.55913978,34,91.2,0.222222222,Poland-Ekstraklasa,2022/05/06,2022/05/08 11:30
4,Lechia Gdansk,31,15,8,8,49,34,15,11,3,1,27,9,16,4,5,7,22,25,53,15,2.68,1.096774194,0.6,1.5625,1.580645161,1.8,1.375,36.55913978,26.88172043,36.55913978,34,91.2,0.222222222,Poland-Ekstraklasa,2022/05/06,2022/04/30 16:30
5,Piast Gliw,31,14,8,9,42,34,15,7,3,5,21,19,16,7,5,4,21,15,50,8,2.45,1.096774194,1.266666667,0.9375,1.35483871,1.4,1.3125,36.55913978,26.88172043,36.55913978,34,91.2,0.277777778,Poland-Ekstraklasa,2022/05/06,2022/05/08 16:30
6,Wisla Plock,31,14,3,14,45,45,15,10,2,3,24,11,16,4,1,11,21,34,45,0,2.9,1.451612903,0.733333333,2.125,1.451612903,1.6,1.3125,36.55913978,26.88172043,36.55913978,34,91.2,0.333333333,Poland-Ekstraklasa,2022/05/06,2022/05/07 14:00
6,Wisla Plock,31,14,3,14,45,45,15,10,2,3,24,11,16,4,1,11,21,34,45,0,2.9,1.451612903,0.733333333,2.125,1.451612903,1.6,1.3125,36.55913978,26.88172043,36.55913978,34,91.2,0.333333333,Poland-Ekstraklasa,2022/05/06,2022/05/01 14:00
7,Radomiak,31,10,14,7,36,31,15,6,7,2,21,14,16,4,7,5,15,17,44,5,2.16,1,0.933333333,1.0625,1.161290323,1.4,0.9375,36.55913978,26.88172043,36.55913978,34,91.2,0.388888889,Poland-Ekstraklasa,2022/05/06,2022/05/06 17:00
7,Radomiak,31,10,14,7,36,31,15,6,7,2,21,14,16,4,7,5,15,17,44,5,2.16,1,0.933333333,1.0625,1.161290323,1.4,0.9375,36.55913978,26.88172043,36.55913978,34,91.2,0.388888889,Poland-Ekstraklasa,2022/05/06,2022/04/29 19:30
8,Cracovia Kr,31,11,9,11,36,38,16,6,5,5,21,19,15,5,4,6,15,19,42,-2,2.39,1.225806452,1.1875,1.266666667,1.161290323,1.3125,1,36.55913978,26.88172043,36.55913978,34,91.2,0.444444444,Poland-Ekstraklasa,2022/05/06,2022/05/01 16:30
8,Cracovia Kr,31,11,9,11,36,38,16,6,5,5,21,19,15,5,4,6,15,19,42,-2,2.39,1.225806452,1.1875,1.266666667,1.161290323,1.3125,1,36.55913978,26.88172043,36.55913978,34,91.2,0.444444444,Poland-Ekstraklasa,2022/05/06,2022/05/08 14:00
9,Gornik Zabrze,31,11,8,12,44,45,16,6,5,5,22,19,15,5,3,7,22,26,41,-1,2.87,1.451612903,1.1875,1.733333333,1.419354839,1.375,1.466666667,36.55913978,26.88172043,36.55913978,34,91.2,0.5,Poland-Ekstraklasa,2022/05/06,2022/04/29 19:30
9,Gornik Zabrze,31,11,8,12,44,45,16,6,5,5,22,19,15,5,3,7,22,26,41,-1,2.87,1.451612903,1.1875,1.733333333,1.419354839,1.375,1.466666667,36.55913978,26.88172043,36.55913978,34,91.2,0.5,Poland-Ekstraklasa,2022/05/06,2022/05/06 19:30
10,Warta Poznan,31,9,9,13,30,36,16,4,6,6,15,20,15,5,3,7,15,16,36,-6,2.13,1.161290323,1.25,1.066666667,0.967741935,0.9375,1,36.55913978,26.88172043,36.55913978,34,91.2,0.555555556,Poland-Ekstraklasa,2022/05/06,2022/05/07 14:00
11,Legia Warsaw,31,11,3,17,36,43,15,8,0,7,21,18,16,3,3,10,15,25,36,-7,2.55,1.387096774,1.2,1.5625,1.161290323,1.4,0.9375,36.55913978,26.88172043,36.55913978,34,91.2,0.611111111,Poland-Ekstraklasa,2022/05/06,2022/05/06 19:30
11,Legia Warsaw,31,11,3,17,36,43,15,8,0,7,21,18,16,3,3,10,15,25,36,-7,2.55,1.387096774,1.2,1.5625,1.161290323,1.4,0.9375,36.55913978,26.88172043,36.55913978,34,91.2,0.611111111,Poland-Ekstraklasa,2022/05/06,2022/04/30 19:00
12,Stal Mielec,31,9,9,13,36,45,16,7,3,6,20,20,15,2,6,7,16,25,36,-9,2.61,1.451612903,1.25,1.666666667,1.161290323,1.25,1.066666667,36.55913978,26.88172043,36.55913978,34,91.2,0.666666667,Poland-Ekstraklasa,2022/05/06,2022/04/30 19:00
12,Stal Mielec,31,9,9,13,36,45,16,7,3,6,20,20,15,2,6,7,16,25,36,-9,2.61,1.451612903,1.25,1.666666667,1.161290323,1.25,1.066666667,36.55913978,26.88172043,36.55913978,34,91.2,0.666666667,Poland-Ekstraklasa,2022/05/06,2022/05/08 11:30
13,Jagiellonia,31,8,11,12,36,48,16,5,7,4,21,18,15,3,4,8,15,30,35,-12,2.71,1.548387097,1.125,2,1.161290323,1.3125,1,36.55913978,26.88172043,36.55913978,34,91.2,0.722222222,Poland-Ekstraklasa,2022/05/06,2022/04/30 14:00
13,Jagiellonia,31,8,11,12,36,48,16,5,7,4,21,18,15,3,4,8,15,30,35,-12,2.71,1.548387097,1.125,2,1.161290323,1.3125,1,36.55913978,26.88172043,36.55913978,34,91.2,0.722222222,Poland-Ekstraklasa,2022/05/06,2022/05/07 19:00
14,Slask Wroclaw,31,7,12,12,37,46,15,3,7,5,14,20,16,4,5,7,23,26,33,-9,2.68,1.483870968,1.333333333,1.625,1.193548387,0.933333333,1.4375,36.55913978,26.88172043,36.55913978,34,91.2,0.777777778,Poland-Ekstraklasa,2022/05/06,2022/05/07 16:30
14,Slask Wroclaw,31,7,12,12,37,46,15,3,7,5,14,20,16,4,5,7,23,26,33,-9,2.68,1.483870968,1.333333333,1.625,1.193548387,0.933333333,1.4375,36.55913978,26.88172043,36.55913978,34,91.2,0.777777778,Poland-Ekstraklasa,2022/05/06,2022/04/30 14:00
15,Zaglebie Lub,31,9,5,17,35,56,16,6,3,7,24,28,15,3,2,10,11,28,32,-21,2.94,1.806451613,1.75,1.866666667,1.129032258,1.5,0.733333333,36.55913978,26.88172043,36.55913978,34,91.2,0.833333333,Poland-Ekstraklasa,2022/05/06,2022/04/30 16:30
15,Zaglebie Lub,31,9,5,17,35,56,16,6,3,7,24,28,15,3,2,10,11,28,32,-21,2.94,1.806451613,1.75,1.866666667,1.129032258,1.5,0.733333333,36.55913978,26.88172043,36.55913978,34,91.2,0.833333333,Poland-Ekstraklasa,2022/05/06,2022/05/06 17:00
16,Wisla Krakow,31,7,9,15,35,49,15,5,4,6,21,20,16,2,5,9,14,29,30,-14,2.71,1.580645161,1.333333333,1.8125,1.129032258,1.4,0.875,36.55913978,26.88172043,36.55913978,34,91.2,0.888888889,Poland-Ekstraklasa,2022/05/06,2022/05/07 19:00
16,Wisla Krakow,31,7,9,15,35,49,15,5,4,6,21,20,16,2,5,9,14,29,30,-14,2.71,1.580645161,1.333333333,1.8125,1.129032258,1.4,0.875,36.55913978,26.88172043,36.55913978,34,91.2,0.888888889,Poland-Ekstraklasa,2022/05/06,2022/05/01 16:30
17,Nieciecza,31,7,9,15,33,52,16,5,5,6,19,25,15,2,4,9,14,27,30,-19,2.74,1.677419355,1.5625,1.8,1.064516129,1.1875,0.933333333,36.55913978,26.88172043,36.55913978,34,91.2,0.944444444,Poland-Ekstraklasa,2022/05/06,2022/05/01 14:00
17,Nieciecza,31,7,9,15,33,52,16,5,5,6,19,25,15,2,4,9,14,27,30,-19,2.74,1.677419355,1.5625,1.8,1.064516129,1.1875,0.933333333,36.55913978,26.88172043,36.55913978,34,91.2,0.944444444,Poland-Ekstraklasa,2022/05/06,2022/05/09 17:00
18,Gornik Leczna,31,6,9,16,26,54,15,4,5,6,14,25,16,2,4,10,12,29,27,-28,2.58,1.741935484,1.666666667,1.8125,0.838709677,0.933333333,0.75,36.55913978,26.88172043,36.55913978,34,91.2,1,Poland-Ekstraklasa,2022/05/06,2022/05/09 17:00
1,Miedz,31,20,8,3,52,22,16,10,4,2,27,12,15,10,4,1,25,10,68,30,2.39,0.709677419,0.75,0.666666667,1.677419355,1.6875,1.666666667,35.12544803,29.74910394,35.12544803,34,91.2,0.055555556,Poland-I-Liga,2022/05/06,2022/05/08 11:40
2,Widzew Lodz,31,17,8,6,50,32,15,10,2,3,33,18,16,7,6,3,17,14,59,18,2.65,1.032258065,1.2,0.875,1.612903226,2.2,1.0625,35.12544803,29.74910394,35.12544803,34,91.2,0.111111111,Poland-I-Liga,2022/05/06,2022/05/07 17:00
2,Widzew Lodz,31,17,8,6,50,32,15,10,2,3,33,18,16,7,6,3,17,14,59,18,2.65,1.032258065,1.2,0.875,1.612903226,2.2,1.0625,35.12544803,29.74910394,35.12544803,34,91.2,0.111111111,Poland-I-Liga,2022/05/06,2022/05/03 17:00
3,Arka Gdynia,31,18,3,10,59,35,15,10,3,2,30,11,16,8,0,8,29,24,57,24,3.03,1.129032258,0.733333333,1.5,1.903225806,2,1.8125,35.12544803,29.74910394,35.12544803,34,91.2,0.166666667,Poland-I-Liga,2022/05/06,2022/05/08 11:40
3,Arka Gdynia,31,18,3,10,59,35,15,10,3,2,30,11,16,8,0,8,29,24,57,24,3.03,1.129032258,0.733333333,1.5,1.903225806,2,1.8125,35.12544803,29.74910394,35.12544803,34,91.2,0.166666667,Poland-I-Liga,2022/05/06,2022/05/01 14:00
4,Korona Kiel,31,15,10,6,43,31,16,9,3,4,22,15,15,6,7,2,21,16,55,12,2.39,1,0.9375,1.066666667,1.387096774,1.375,1.4,35.12544803,29.74910394,35.12544803,34,91.2,0.222222222,Poland-I-Liga,2022/05/06,2022/05/06 19:30
5,Chrobry Glo,31,12,10,9,38,31,15,9,5,1,22,7,16,3,5,8,16,24,46,7,2.23,1,0.466666667,1.5,1.225806452,1.466666667,1,35.12544803,29.74910394,35.12544803,34,91.2,0.277777778,Poland-I-Liga,2022/05/06,2022/05/08 17:00
6,Sandecja,31,12,9,10,35,31,16,4,6,6,18,19,15,8,3,4,17,12,45,4,2.13,1,1.1875,0.8,1.129032258,1.125,1.133333333,35.12544803,29.74910394,35.12544803,34,91.2,0.333333333,Poland-I-Liga,2022/05/06,2022/05/02 11:40
6,Sandecja,31,12,9,10,35,31,16,4,6,6,18,19,15,8,3,4,17,12,45,4,2.13,1,1.1875,0.8,1.129032258,1.125,1.133333333,35.12544803,29.74910394,35.12544803,34,91.2,0.333333333,Poland-I-Liga,2022/05/06,2022/05/09 17:00
7,Odra O,31,12,9,10,44,42,15,6,5,4,21,18,16,6,4,6,23,24,45,2,2.77,1.35483871,1.2,1.5,1.419354839,1.4,1.4375,35.12544803,29.74910394,35.12544803,34,91.2,0.388888889,Poland-I-Liga,2022/05/06,2022/05/06 19:30
7,Odra O,31,12,9,10,44,42,15,6,5,4,21,18,16,6,4,6,23,24,45,2,2.77,1.35483871,1.2,1.5,1.419354839,1.4,1.4375,35.12544803,29.74910394,35.12544803,34,91.2,0.388888889,Poland-I-Liga,2022/05/06,2022/05/01 14:00
8,LKS Lodz,31,11,9,11,31,31,16,6,3,7,16,18,15,5,6,4,15,13,42,0,2,1,1.125,0.866666667,1,1,1,35.12544803,29.74910394,35.12544803,34,91.2,0.444444444,Poland-I-Liga,2022/05/06,2022/05/03 17:00
8,LKS Lodz,31,11,9,11,31,31,16,6,3,7,16,18,15,5,6,4,15,13,42,0,2,1,1.125,0.866666667,1,1,1,35.12544803,29.74910394,35.12544803,34,91.2,0.444444444,Poland-I-Liga,2022/05/06,2022/05/08 14:00
9,Podbeskidzie,31,10,11,10,43,37,16,6,4,6,22,15,15,4,7,4,21,22,41,6,2.58,1.193548387,0.9375,1.466666667,1.387096774,1.375,1.4,35.12544803,29.74910394,35.12544803,34,91.2,0.5,Poland-I-Liga,2022/05/06,2022/05/08 17:00
10,GKS Tychy 71,31,10,10,11,31,36,15,5,6,4,16,16,16,5,4,7,15,20,40,-5,2.16,1.161290323,1.066666667,1.25,1,1.066666667,0.9375,35.12544803,29.74910394,35.12544803,34,91.2,0.555555556,Poland-I-Liga,2022/05/06,2022/05/07 11:40
10,GKS Tychy 71,31,10,10,11,31,36,15,5,6,4,16,16,16,5,4,7,15,20,40,-5,2.16,1.161290323,1.066666667,1.25,1,1.066666667,0.9375,35.12544803,29.74910394,35.12544803,34,91.2,0.555555556,Poland-I-Liga,2022/05/06,2022/05/02 19:00
11,Resovia Rzes,31,9,11,11,35,35,17,5,7,5,19,16,14,4,4,6,16,19,38,0,2.26,1.129032258,0.941176471,1.357142857,1.129032258,1.117647059,1.142857143,35.12544803,29.74910394,35.12544803,34,91.2,0.611111111,Poland-I-Liga,2022/05/06,2022/05/01 14:00
11,Resovia Rzes,31,9,11,11,35,35,17,5,7,5,19,16,14,4,4,6,16,19,38,0,2.26,1.129032258,0.941176471,1.357142857,1.129032258,1.117647059,1.142857143,35.12544803,29.74910394,35.12544803,34,91.2,0.611111111,Poland-I-Liga,2022/05/06,2022/05/07 17:00
12,Katowice,31,8,13,10,37,45,15,5,5,5,22,23,16,3,8,5,15,22,37,-8,2.65,1.451612903,1.533333333,1.375,1.193548387,1.466666667,0.9375,35.12544803,29.74910394,35.12544803,34,91.2,0.666666667,Poland-I-Liga,2022/05/06,2022/05/07 19:30
12,Katowice,31,8,13,10,37,45,15,5,5,5,22,23,16,3,8,5,15,22,37,-8,2.65,1.451612903,1.533333333,1.375,1.193548387,1.466666667,0.9375,35.12544803,29.74910394,35.12544803,34,91.2,0.666666667,Poland-I-Liga,2022/05/06,2022/05/01 17:00
13,Skra,31,8,12,11,26,38,14,2,8,4,14,19,17,6,4,7,12,19,36,-12,2.06,1.225806452,1.357142857,1.117647059,0.838709677,1,0.705882353,35.12544803,29.74910394,35.12544803,34,91.2,0.722222222,Poland-I-Liga,2022/05/06,2022/05/02 19:00
13,Skra,31,8,12,11,26,38,14,2,8,4,14,19,17,6,4,7,12,19,36,-12,2.06,1.225806452,1.357142857,1.117647059,0.838709677,1,0.705882353,35.12544803,29.74910394,35.12544803,34,91.2,0.722222222,Poland-I-Liga,2022/05/06,2022/05/06 17:00
14,Zaglebie Son,31,8,10,13,38,41,15,4,5,6,18,16,16,4,5,7,20,25,34,-3,2.55,1.322580645,1.066666667,1.5625,1.225806452,1.2,1.25,35.12544803,29.74910394,35.12544803,34,91.2,0.777777778,Poland-I-Liga,2022/05/06,2022/05/09 17:00
15,Puszcza Nie,31,9,7,15,38,45,17,5,5,7,26,23,14,4,2,8,12,22,34,-7,2.68,1.451612903,1.352941176,1.571428571,1.225806452,1.529411765,0.857142857,35.12544803,29.74910394,35.12544803,34,91.2,0.833333333,Poland-I-Liga,2022/05/06,2022/05/01 17:00
15,Puszcza Nie,31,9,7,15,38,45,17,5,5,7,26,23,14,4,2,8,12,22,34,-7,2.68,1.451612903,1.352941176,1.571428571,1.225806452,1.529411765,0.857142857,35.12544803,29.74910394,35.12544803,34,91.2,0.833333333,Poland-I-Liga,2022/05/06,2022/05/07 11:40
16,Olsztyn,31,9,3,19,31,52,16,4,0,12,17,30,15,5,3,7,14,22,30,-21,2.68,1.677419355,1.875,1.466666667,1,1.0625,0.933333333,35.12544803,29.74910394,35.12544803,34,91.2,0.888888889,Poland-I-Liga,2022/05/06,2022/05/02 11:40
16,Olsztyn,31,9,3,19,31,52,16,4,0,12,17,30,15,5,3,7,14,22,30,-21,2.68,1.677419355,1.875,1.466666667,1,1.0625,0.933333333,35.12544803,29.74910394,35.12544803,34,91.2,0.888888889,Poland-I-Liga,2022/05/06,2022/05/06 17:00
17,Gornik Polkow,31,4,14,13,29,51,14,2,8,4,12,16,17,2,6,9,17,35,26,-22,2.58,1.64516129,1.142857143,2.058823529,0.935483871,0.857142857,1,35.12544803,29.74910394,35.12544803,34,91.2,0.944444444,Poland-I-Liga,2022/05/06,2022/05/08 14:00
18,GKS Jast Z,31,4,9,18,27,52,16,3,4,9,13,27,15,1,5,9,14,25,21,-25,2.55,1.677419355,1.6875,1.666666667,0.870967742,0.8125,0.933333333,35.12544803,29.74910394,35.12544803,34,91.2,1,Poland-I-Liga,2022/05/06,2022/05/01 14:00
18,GKS Jast Z,31,4,9,18,27,52,16,3,4,9,13,27,15,1,5,9,14,25,21,-25,2.55,1.677419355,1.6875,1.666666667,0.870967742,0.8125,0.933333333,35.12544803,29.74910394,35.12544803,34,91.2,1,Poland-I-Liga,2022/05/06,2022/05/07 19:30
1,Gazovik O,35,23,3,9,60,32,18,14,1,3,30,12,17,9,2,6,30,20,72,28,2.63,0.914285714,0.666666667,1.176470588,1.714285714,1.666666667,1.764705882,38.2183908,23.56321839,38.2183908,38,92.1,0.05,Russia-FNL,2022/05/06,2022/05/07 13:00
2,Torp Moscow,34,17,14,3,58,33,17,9,8,0,33,13,17,8,6,3,25,20,65,25,2.68,0.970588235,0.764705882,1.176470588,1.705882353,1.941176471,1.470588235,38.2183908,23.56321839,38.2183908,38,89.5,0.1,Russia-FNL,2022/05/06,2022/05/07 12:00
3,Fakel Voronz,34,19,5,10,55,32,17,12,3,2,27,10,17,7,2,8,28,22,62,23,2.56,0.941176471,0.588235294,1.294117647,1.617647059,1.588235294,1.647058824,38.2183908,23.56321839,38.2183908,38,89.5,0.15,Russia-FNL,2022/05/06,2022/05/07 14:00
4,Yenisey,35,18,6,11,55,48,17,10,4,3,29,19,18,8,2,8,26,29,60,7,2.94,1.371428571,1.117647059,1.611111111,1.571428571,1.705882353,1.444444444,38.2183908,23.56321839,38.2183908,38,92.1,0.2,Russia-FNL,2022/05/06,2022/05/07 16:00
5,Energ Khabar,35,17,8,10,45,35,16,12,1,3,28,13,19,5,7,7,17,22,59,10,2.29,1,0.8125,1.157894737,1.285714286,1.75,0.894736842,38.2183908,23.56321839,38.2183908,38,92.1,0.25,Russia-FNL,2022/05/06,2022/05/07 06:00
6,Alaniya Vlad,35,16,9,10,70,45,17,11,1,5,38,20,18,5,8,5,32,25,57,25,3.29,1.285714286,1.176470588,1.388888889,2,2.235294118,1.777777778,38.2183908,23.56321839,38.2183908,38,92.1,0.3,Russia-FNL,2022/05/06,2022/04/30 14:00
6,Alaniya Vlad,35,16,9,10,70,45,17,11,1,5,38,20,18,5,8,5,32,25,57,25,3.29,1.285714286,1.176470588,1.388888889,2,2.235294118,1.777777778,38.2183908,23.56321839,38.2183908,38,92.1,0.3,Russia-FNL,2022/05/06,2022/05/06 15:00
7,Baltika Kalin,35,14,14,7,50,28,17,7,7,3,21,11,18,7,7,4,29,17,56,22,2.23,0.8,0.647058824,0.944444444,1.428571429,1.235294118,1.611111111,38.2183908,23.56321839,38.2183908,38,92.1,0.35,Russia-FNL,2022/05/06,2022/05/07 16:00
7,Baltika Kalin,35,14,14,7,50,28,17,7,7,3,21,11,18,7,7,4,29,17,56,22,2.23,0.8,0.647058824,0.944444444,1.428571429,1.235294118,1.611111111,38.2183908,23.56321839,38.2183908,38,92.1,0.35,Russia-FNL,2022/05/06,2022/04/30 14:00
8,Neft Nizhnek,35,15,7,13,51,38,18,8,4,6,29,17,17,7,3,7,22,21,52,13,2.54,1.085714286,0.944444444,1.235294118,1.457142857,1.611111111,1.294117647,38.2183908,23.56321839,38.2183908,38,92.1,0.4,Russia-FNL,2022/05/06,2022/05/06 15:00
8,Neft Nizhnek,35,15,7,13,51,38,18,8,4,6,29,17,17,7,3,7,22,21,52,13,2.54,1.085714286,0.944444444,1.235294118,1.457142857,1.611111111,1.294117647,38.2183908,23.56321839,38.2183908,38,92.1,0.4,Russia-FNL,2022/05/06,2022/04/30 14:00
9,Akron Tolyat,35,13,10,12,38,39,18,10,4,4,23,16,17,3,6,8,15,23,49,-1,2.2,1.114285714,0.888888889,1.352941176,1.085714286,1.277777778,0.882352941,38.2183908,23.56321839,38.2183908,38,92.1,0.45,Russia-FNL,2022/05/06,2022/05/07 13:00
9,Akron Tolyat,35,13,10,12,38,39,18,10,4,4,23,16,17,3,6,8,15,23,49,-1,2.2,1.114285714,0.888888889,1.352941176,1.085714286,1.277777778,0.882352941,38.2183908,23.56321839,38.2183908,38,92.1,0.45,Russia-FNL,2022/05/06,2022/04/30 14:00
10,Krasnodar 2,35,14,7,14,40,42,17,9,4,4,28,18,18,5,3,10,12,24,49,-2,2.34,1.2,1.058823529,1.333333333,1.142857143,1.647058824,0.666666667,38.2183908,23.56321839,38.2183908,38,92.1,0.5,Russia-FNL,2022/05/06,2022/05/07 16:00
11,Sp Moscow 2,35,15,4,16,41,54,18,7,4,7,21,24,17,8,0,9,20,30,49,-13,2.71,1.542857143,1.333333333,1.764705882,1.171428571,1.166666667,1.176470588,38.2183908,23.56321839,38.2183908,38,92.1,0.55,Russia-FNL,2022/05/06,2022/04/30 14:00
11,Sp Moscow 2,35,15,4,16,41,54,18,7,4,7,21,24,17,8,0,9,20,30,49,-13,2.71,1.542857143,1.333333333,1.764705882,1.171428571,1.166666667,1.176470588,38.2183908,23.56321839,38.2183908,38,92.1,0.55,Russia-FNL,2022/05/06,2022/05/07 13:00
12,Veles,35,14,5,16,42,43,18,8,3,7,25,27,17,6,2,9,17,16,47,-1,2.43,1.228571429,1.5,0.941176471,1.2,1.388888889,1,38.2183908,23.56321839,38.2183908,38,92.1,0.6,Russia-FNL,2022/05/06,2022/05/07 12:00
13,Kuban Kras,35,13,7,15,43,46,18,6,3,9,20,31,17,7,4,6,23,15,46,-3,2.54,1.314285714,1.722222222,0.882352941,1.228571429,1.111111111,1.352941176,38.2183908,23.56321839,38.2183908,38,92.1,0.65,Russia-FNL,2022/05/06,2022/04/30 17:00
13,Kuban Kras,35,13,7,15,43,46,18,6,3,9,20,31,17,7,4,6,23,15,46,-3,2.54,1.314285714,1.722222222,0.882352941,1.228571429,1.111111111,1.352941176,38.2183908,23.56321839,38.2183908,38,92.1,0.65,Russia-FNL,2022/05/06,2022/05/07 14:00
14,Tom Tomsk,35,12,8,15,46,56,18,9,4,5,22,21,17,3,4,10,24,35,44,-10,2.91,1.6,1.166666667,2.058823529,1.314285714,1.222222222,1.411764706,38.2183908,23.56321839,38.2183908,38,92.1,0.7,Russia-FNL,2022/05/06,2022/04/30 15:00
14,Tom Tomsk,35,12,8,15,46,56,18,9,4,5,22,21,17,3,4,10,24,35,44,-10,2.91,1.6,1.166666667,2.058823529,1.314285714,1.222222222,1.411764706,38.2183908,23.56321839,38.2183908,38,92.1,0.7,Russia-FNL,2022/05/06,2022/05/07 06:00
15,Ol Dolgoprud,35,9,13,13,31,39,17,6,7,4,17,18,18,3,6,9,14,21,40,-8,2,1.114285714,1.058823529,1.166666667,0.885714286,1,0.777777778,38.2183908,23.56321839,38.2183908,38,92.1,0.75,Russia-FNL,2022/05/06,2022/04/30 15:00
15,Ol Dolgoprud,35,9,13,13,31,39,17,6,7,4,17,18,18,3,6,9,14,21,40,-8,2,1.114285714,1.058823529,1.166666667,0.885714286,1,0.777777778,38.2183908,23.56321839,38.2183908,38,92.1,0.75,Russia-FNL,2022/05/06,2022/05/07 13:00
16,Volgar Gazp,35,10,8,17,28,37,17,4,5,8,12,18,18,6,3,9,16,19,38,-9,1.86,1.057142857,1.058823529,1.055555556,0.8,0.705882353,0.888888889,38.2183908,23.56321839,38.2183908,38,92.1,0.8,Russia-FNL,2022/05/06,2022/04/30 14:00
16,Volgar Gazp,35,10,8,17,28,37,17,4,5,8,12,18,18,6,3,9,16,19,38,-9,1.86,1.057142857,1.058823529,1.055555556,0.8,0.705882353,0.888888889,38.2183908,23.56321839,38.2183908,38,92.1,0.8,Russia-FNL,2022/05/06,2022/05/07 14:00
17,KamAZ Chally,34,8,12,14,27,38,18,6,5,7,20,21,16,2,7,7,7,17,36,-11,1.91,1.117647059,1.166666667,1.0625,0.794117647,1.111111111,0.4375,38.2183908,23.56321839,38.2183908,38,89.5,0.85,Russia-FNL,2022/05/06,2022/05/07 14:00
18,Metallurg Lipe,34,9,4,21,27,63,17,4,4,9,11,24,17,5,0,12,16,39,31,-36,2.65,1.852941176,1.411764706,2.294117647,0.794117647,0.647058824,0.941176471,38.2183908,23.56321839,38.2183908,38,89.5,0.9,Russia-FNL,2022/05/06,2022/05/07 16:00
19,Rotor Volgo,35,6,12,17,33,51,18,2,7,9,14,29,17,4,5,8,19,22,30,-18,2.4,1.457142857,1.611111111,1.294117647,0.942857143,0.777777778,1.117647059,38.2183908,23.56321839,38.2183908,38,92.1,0.95,Russia-FNL,2022/05/06,2022/05/07 13:00
19,Rotor Volgo,35,6,12,17,33,51,18,2,7,9,14,29,17,4,5,8,19,22,30,-18,2.4,1.457142857,1.611111111,1.294117647,0.942857143,0.777777778,1.117647059,38.2183908,23.56321839,38.2183908,38,92.1,0.95,Russia-FNL,2022/05/06,2022/04/30 17:00
20,Tekstilshchik,35,4,8,23,28,69,17,4,3,10,22,36,18,0,5,13,6,33,20,-41,2.77,1.971428571,2.117647059,1.833333333,0.8,1.294117647,0.333333333,38.2183908,23.56321839,38.2183908,38,92.1,1,Russia-FNL,2022/05/06,2022/05/07 13:00
1,Al Ittihad SA,25,19,3,3,54,20,13,11,1,1,30,7,12,8,2,2,24,13,60,34,2.96,0.8,0.538461538,1.083333333,2.16,2.307692308,2,36.31840796,27.36318408,36.31840796,30,83.3,0.0625,Saudi-Arabia-Pro-League,2022/05/06,2022/03/18 16:05
1,Al Ittihad SA,25,19,3,3,54,20,13,11,1,1,30,7,12,8,2,2,24,13,60,34,2.96,0.8,0.538461538,1.083333333,2.16,2.307692308,2,36.31840796,27.36318408,36.31840796,30,83.3,0.0625,Saudi-Arabia-Pro-League,2022/05/06,2022/05/06 16:50
2,Al Hilal,24,14,7,3,47,24,13,9,2,2,27,14,11,5,5,1,20,10,49,23,2.96,1,1.076923077,0.909090909,1.958333333,2.076923077,1.818181818,36.31840796,27.36318408,36.31840796,30,80,0.125,Saudi-Arabia-Pro-League,2022/05/06,2022/03/18 17:50
2,Al Hilal,24,14,7,3,47,24,13,9,2,2,27,14,11,5,5,1,20,10,49,23,2.96,1,1.076923077,0.909090909,1.958333333,2.076923077,1.818181818,36.31840796,27.36318408,36.31840796,30,80,0.125,Saudi-Arabia-Pro-League,2022/05/06,2022/05/03 17:10
2,Al Hilal,24,14,7,3,47,24,13,9,2,2,27,14,11,5,5,1,20,10,49,23,2.96,1,1.076923077,0.909090909,1.958333333,2.076923077,1.818181818,36.31840796,27.36318408,36.31840796,30,80,0.125,Saudi-Arabia-Pro-League,2022/05/06,2022/05/07 17:10
3,Al Nasr SA,25,15,3,7,44,31,12,8,1,3,24,15,13,7,2,4,20,16,48,13,3,1.24,1.25,1.230769231,1.76,2,1.538461538,36.31840796,27.36318408,36.31840796,30,83.3,0.1875,Saudi-Arabia-Pro-League,2022/05/06,2022/03/17 17:50
3,Al Nasr SA,25,15,3,7,44,31,12,8,1,3,24,15,13,7,2,4,20,16,48,13,3,1.24,1.25,1.230769231,1.76,2,1.538461538,36.31840796,27.36318408,36.31840796,30,83.3,0.1875,Saudi-Arabia-Pro-League,2022/05/06,2022/05/06 18:50
4,Al Shabab SA,25,13,8,4,46,31,13,8,4,1,27,12,12,5,4,3,19,19,47,15,3.08,1.24,0.923076923,1.583333333,1.84,2.076923077,1.583333333,36.31840796,27.36318408,36.31840796,30,83.3,0.25,Saudi-Arabia-Pro-League,2022/05/06,2022/03/18 16:00
4,Al Shabab SA,25,13,8,4,46,31,13,8,4,1,27,12,12,5,4,3,19,19,47,15,3.08,1.24,0.923076923,1.583333333,1.84,2.076923077,1.583333333,36.31840796,27.36318408,36.31840796,30,83.3,0.25,Saudi-Arabia-Pro-League,2022/05/06,2022/05/06 18:50
5,Dhamk,25,12,6,7,34,34,12,7,4,1,16,10,13,5,2,6,18,24,42,0,2.72,1.36,0.833333333,1.846153846,1.36,1.333333333,1.384615385,36.31840796,27.36318408,36.31840796,30,83.3,0.3125,Saudi-Arabia-Pro-League,2022/05/06,2022/05/07 17:10
6,Al Feiha,25,8,9,8,20,19,12,7,4,1,11,3,13,1,5,7,9,16,33,1,1.56,0.76,0.25,1.230769231,0.8,0.916666667,0.692307692,36.31840796,27.36318408,36.31840796,30,83.3,0.375,Saudi-Arabia-Pro-League,2022/05/06,2022/05/03 17:10
6,Al Feiha,25,8,9,8,20,19,12,7,4,1,11,3,13,1,5,7,9,16,33,1,1.56,0.76,0.25,1.230769231,0.8,0.916666667,0.692307692,36.31840796,27.36318408,36.31840796,30,83.3,0.375,Saudi-Arabia-Pro-League,2022/05/06,2022/03/17 17:50
6,Al Feiha,25,8,9,8,20,19,12,7,4,1,11,3,13,1,5,7,9,16,33,1,1.56,0.76,0.25,1.230769231,0.8,0.916666667,0.692307692,36.31840796,27.36318408,36.31840796,30,83.3,0.375,Saudi-Arabia-Pro-League,2022/05/06,2022/05/07 17:20
7,Abha,25,9,5,11,26,39,13,7,3,3,17,16,12,2,2,8,9,23,32,-13,2.6,1.56,1.230769231,1.916666667,1.04,1.307692308,0.75,36.31840796,27.36318408,36.31840796,30,83.3,0.4375,Saudi-Arabia-Pro-League,2022/05/06,2022/03/19 15:55
7,Abha,25,9,5,11,26,39,13,7,3,3,17,16,12,2,2,8,9,23,32,-13,2.6,1.56,1.230769231,1.916666667,1.04,1.307692308,0.75,36.31840796,27.36318408,36.31840796,30,83.3,0.4375,Saudi-Arabia-Pro-League,2022/05/06,2022/05/06 17:10
8,Al Fateh,25,8,7,10,36,30,12,5,2,5,26,16,13,3,5,5,10,14,31,6,2.64,1.2,1.333333333,1.076923077,1.44,2.166666667,0.769230769,36.31840796,27.36318408,36.31840796,30,83.3,0.5,Saudi-Arabia-Pro-League,2022/05/06,2022/05/06 16:50
9,Al Ahli SA,26,6,11,9,35,38,13,4,6,3,22,17,13,2,5,6,13,21,29,-3,2.81,1.461538462,1.307692308,1.615384615,1.346153846,1.692307692,1,36.31840796,27.36318408,36.31840796,30,86.7,0.5625,Saudi-Arabia-Pro-League,2022/05/06,2022/03/18 17:50
9,Al Ahli SA,26,6,11,9,35,38,13,4,6,3,22,17,13,2,5,6,13,21,29,-3,2.81,1.461538462,1.307692308,1.615384615,1.346153846,1.692307692,1,36.31840796,27.36318408,36.31840796,30,86.7,0.5625,Saudi-Arabia-Pro-League,2022/05/06,2022/05/05 18:50
10,Al Raed,25,8,5,12,29,37,12,6,2,4,13,10,13,2,3,8,16,27,29,-8,2.64,1.48,0.833333333,2.076923077,1.16,1.083333333,1.230769231,36.31840796,27.36318408,36.31840796,30,83.3,0.625,Saudi-Arabia-Pro-League,2022/05/06,2022/03/19 15:45
10,Al Raed,25,8,5,12,29,37,12,6,2,4,13,10,13,2,3,8,16,27,29,-8,2.64,1.48,0.833333333,2.076923077,1.16,1.083333333,1.230769231,36.31840796,27.36318408,36.31840796,30,83.3,0.625,Saudi-Arabia-Pro-League,2022/05/06,2022/05/07 18:50
11,Al Faisaly,25,6,10,9,25,33,13,6,5,2,19,13,12,0,5,7,6,20,28,-8,2.32,1.32,1,1.666666667,1,1.461538462,0.5,36.31840796,27.36318408,36.31840796,30,83.3,0.6875,Saudi-Arabia-Pro-League,2022/05/06,2022/05/06 17:10
12,Al Ittifaq,25,6,9,10,32,39,12,3,5,4,13,15,13,3,4,6,19,24,27,-7,2.84,1.56,1.25,1.846153846,1.28,1.083333333,1.461538462,36.31840796,27.36318408,36.31840796,30,83.3,0.75,Saudi-Arabia-Pro-League,2022/05/06,2022/05/05 17:20
13,Al Taee,25,8,3,14,25,41,12,5,2,5,19,20,13,3,1,9,6,21,27,-16,2.64,1.64,1.666666667,1.615384615,1,1.583333333,0.461538462,36.31840796,27.36318408,36.31840796,30,83.3,0.8125,Saudi-Arabia-Pro-League,2022/05/06,2022/03/18 16:00
13,Al Taee,25,8,3,14,25,41,12,5,2,5,19,20,13,3,1,9,6,21,27,-16,2.64,1.64,1.666666667,1.615384615,1,1.583333333,0.461538462,36.31840796,27.36318408,36.31840796,30,83.3,0.8125,Saudi-Arabia-Pro-League,2022/05/06,2022/05/07 18:50
14,Al Taawon SA,26,5,11,10,39,46,13,3,5,5,18,21,13,2,6,5,21,25,26,-7,3.27,1.769230769,1.615384615,1.923076923,1.5,1.384615385,1.615384615,36.31840796,27.36318408,36.31840796,30,86.7,0.875,Saudi-Arabia-Pro-League,2022/05/06,2022/05/05 17:20
14,Al Taawon SA,26,5,11,10,39,46,13,3,5,5,18,21,13,2,6,5,21,25,26,-7,3.27,1.769230769,1.615384615,1.923076923,1.5,1.384615385,1.615384615,36.31840796,27.36318408,36.31840796,30,86.7,0.875,Saudi-Arabia-Pro-League,2022/05/06,2022/03/19 15:55
15,Al Baten,26,6,8,12,26,37,14,5,5,4,18,18,12,1,3,8,8,19,26,-11,2.42,1.423076923,1.285714286,1.583333333,1,1.285714286,0.666666667,36.31840796,27.36318408,36.31840796,30,86.7,0.9375,Saudi-Arabia-Pro-League,2022/05/06,2022/03/19 15:45
15,Al Baten,26,6,8,12,26,37,14,5,5,4,18,18,12,1,3,8,8,19,26,-11,2.42,1.423076923,1.285714286,1.583333333,1,1.285714286,0.666666667,36.31840796,27.36318408,36.31840796,30,86.7,0.9375,Saudi-Arabia-Pro-League,2022/05/06,2022/05/05 18:50
16,Al Hazm,25,3,5,17,15,34,12,2,4,6,11,15,13,1,1,11,4,19,14,-19,1.96,1.36,1.25,1.461538462,0.6,0.916666667,0.307692308,36.31840796,27.36318408,36.31840796,30,83.3,1,Saudi-Arabia-Pro-League,2022/05/06,2022/05/07 17:20
16,Al Hazm,25,3,5,17,15,34,12,2,4,6,11,15,13,1,1,11,4,19,14,-19,1.96,1.36,1.25,1.461538462,0.6,0.916666667,0.307692308,36.31840796,27.36318408,36.31840796,30,83.3,1,Saudi-Arabia-Pro-League,2022/05/06,2022/03/18 16:05
1,Foresters FC,12,8,4,0,30,4,6,6,0,0,20,1,6,2,4,0,10,3,28,26,2.83,0.333333333,0.166666667,0.5,2.5,3.333333333,1.666666667,35.22727273,29.54545455,35.22727273,14,85.7,0.125,Seychelles-Division-One,2022/05/06,2022/04/22 14:30
1,Foresters FC,12,8,4,0,30,4,6,6,0,0,20,1,6,2,4,0,10,3,28,26,2.83,0.333333333,0.166666667,0.5,2.5,3.333333333,1.666666667,35.22727273,29.54545455,35.22727273,14,85.7,0.125,Seychelles-Division-One,2022/05/06,2022/05/04 14:30
1,Foresters FC,12,8,4,0,30,4,6,6,0,0,20,1,6,2,4,0,10,3,28,26,2.83,0.333333333,0.166666667,0.5,2.5,3.333333333,1.666666667,35.22727273,29.54545455,35.22727273,14,85.7,0.125,Seychelles-Division-One,2022/05/06,2022/04/30 13:00
2,St Michel Ud,10,8,1,1,29,6,7,5,1,1,21,3,3,3,0,0,8,3,25,23,3.5,0.6,0.428571429,1,2.9,3,2.666666667,35.22727273,29.54545455,35.22727273,14,71.4,0.25,Seychelles-Division-One,2022/05/06,2022/04/08 14:30
2,St Michel Ud,10,8,1,1,29,6,7,5,1,1,21,3,3,3,0,0,8,3,25,23,3.5,0.6,0.428571429,1,2.9,3,2.666666667,35.22727273,29.54545455,35.22727273,14,71.4,0.25,Seychelles-Division-One,2022/05/06,2022/04/23 13:00
2,St Michel Ud,10,8,1,1,29,6,7,5,1,1,21,3,3,3,0,0,8,3,25,23,3.5,0.6,0.428571429,1,2.9,3,2.666666667,35.22727273,29.54545455,35.22727273,14,71.4,0.25,Seychelles-Division-One,2022/05/06,2022/04/29 14:30
2,St Michel Ud,10,8,1,1,29,6,7,5,1,1,21,3,3,3,0,0,8,3,25,23,3.5,0.6,0.428571429,1,2.9,3,2.666666667,35.22727273,29.54545455,35.22727273,14,71.4,0.25,Seychelles-Division-One,2022/05/06,2022/05/06 14:30
3,St Louis Sy,10,6,3,1,15,7,5,2,3,0,7,3,5,4,0,1,8,4,21,8,2.2,0.7,0.6,0.8,1.5,1.4,1.6,35.22727273,29.54545455,35.22727273,14,71.4,0.375,Seychelles-Division-One,2022/05/06,2022/05/06 14:30
3,St Louis Sy,10,6,3,1,15,7,5,2,3,0,7,3,5,4,0,1,8,4,21,8,2.2,0.7,0.6,0.8,1.5,1.4,1.6,35.22727273,29.54545455,35.22727273,14,71.4,0.375,Seychelles-Division-One,2022/05/06,2022/04/08 14:30
3,St Louis Sy,10,6,3,1,15,7,5,2,3,0,7,3,5,4,0,1,8,4,21,8,2.2,0.7,0.6,0.8,1.5,1.4,1.6,35.22727273,29.54545455,35.22727273,14,71.4,0.375,Seychelles-Division-One,2022/05/06,2022/04/22 14:30
3,St Louis Sy,10,6,3,1,15,7,5,2,3,0,7,3,5,4,0,1,8,4,21,8,2.2,0.7,0.6,0.8,1.5,1.4,1.6,35.22727273,29.54545455,35.22727273,14,71.4,0.375,Seychelles-Division-One,2022/05/06,2022/04/27 14:30
4,St Jo Bos Sy,12,3,6,3,13,12,6,1,3,2,5,7,6,2,3,1,8,5,15,1,2.08,1,1.166666667,0.833333333,1.083333333,0.833333333,1.333333333,35.22727273,29.54545455,35.22727273,14,85.7,0.5,Seychelles-Division-One,2022/05/06,2022/04/27 14:30
4,St Jo Bos Sy,12,3,6,3,13,12,6,1,3,2,5,7,6,2,3,1,8,5,15,1,2.08,1,1.166666667,0.833333333,1.083333333,0.833333333,1.333333333,35.22727273,29.54545455,35.22727273,14,85.7,0.5,Seychelles-Division-One,2022/05/06,2022/04/21 14:30
4,St Jo Bos Sy,12,3,6,3,13,12,6,1,3,2,5,7,6,2,3,1,8,5,15,1,2.08,1,1.166666667,0.833333333,1.083333333,0.833333333,1.333333333,35.22727273,29.54545455,35.22727273,14,85.7,0.5,Seychelles-Division-One,2022/05/06,2022/05/04 14:30
5,Red Star Sy,12,2,5,5,12,18,6,1,3,2,8,9,6,1,2,3,4,9,11,-6,2.5,1.5,1.5,1.5,1,1.333333333,0.666666667,35.22727273,29.54545455,35.22727273,14,85.7,0.625,Seychelles-Division-One,2022/05/06,2022/04/30 13:00
5,Red Star Sy,12,2,5,5,12,18,6,1,3,2,8,9,6,1,2,3,4,9,11,-6,2.5,1.5,1.5,1.5,1,1.333333333,0.666666667,35.22727273,29.54545455,35.22727273,14,85.7,0.625,Seychelles-Division-One,2022/05/06,2022/05/05 14:30
5,Red Star Sy,12,2,5,5,12,18,6,1,3,2,8,9,6,1,2,3,4,9,11,-6,2.5,1.5,1.5,1.5,1,1.333333333,0.666666667,35.22727273,29.54545455,35.22727273,14,85.7,0.625,Seychelles-Division-One,2022/05/06,2022/04/09 13:00
5,Red Star Sy,12,2,5,5,12,18,6,1,3,2,8,9,6,1,2,3,4,9,11,-6,2.5,1.5,1.5,1.5,1,1.333333333,0.666666667,35.22727273,29.54545455,35.22727273,14,85.7,0.625,Seychelles-Division-One,2022/05/06,2022/04/20 14:30
6,Rl Maldives,11,2,3,6,13,23,5,1,1,3,5,8,6,1,2,3,8,15,9,-10,3.27,2.090909091,1.6,2.5,1.181818182,1,1.333333333,35.22727273,29.54545455,35.22727273,14,78.6,0.75,Seychelles-Division-One,2022/05/06,2022/04/09 13:00
6,Rl Maldives,11,2,3,6,13,23,5,1,1,3,5,8,6,1,2,3,8,15,9,-10,3.27,2.090909091,1.6,2.5,1.181818182,1,1.333333333,35.22727273,29.54545455,35.22727273,14,78.6,0.75,Seychelles-Division-One,2022/05/06,2022/04/28 14:30
6,Rl Maldives,11,2,3,6,13,23,5,1,1,3,5,8,6,1,2,3,8,15,9,-10,3.27,2.090909091,1.6,2.5,1.181818182,1,1.333333333,35.22727273,29.54545455,35.22727273,14,78.6,0.75,Seychelles-Division-One,2022/05/06,2022/04/23 13:00
6,Rl Maldives,11,2,3,6,13,23,5,1,1,3,5,8,6,1,2,3,8,15,9,-10,3.27,2.090909091,1.6,2.5,1.181818182,1,1.333333333,35.22727273,29.54545455,35.22727273,14,78.6,0.75,Seychelles-Division-One,2022/05/06,2022/05/05 14:30
7,Nrn Dynamo,11,2,2,7,3,29,4,0,1,3,1,9,7,2,1,4,2,20,8,-26,2.91,2.636363636,2.25,2.857142857,0.272727273,0.25,0.285714286,35.22727273,29.54545455,35.22727273,14,78.6,0.875,Seychelles-Division-One,2022/05/06,2022/04/20 14:30
7,Nrn Dynamo,11,2,2,7,3,29,4,0,1,3,1,9,7,2,1,4,2,20,8,-26,2.91,2.636363636,2.25,2.857142857,0.272727273,0.25,0.285714286,35.22727273,29.54545455,35.22727273,14,78.6,0.875,Seychelles-Division-One,2022/05/06,2022/05/07 13:00
7,Nrn Dynamo,11,2,2,7,3,29,4,0,1,3,1,9,7,2,1,4,2,20,8,-26,2.91,2.636363636,2.25,2.857142857,0.272727273,0.25,0.285714286,35.22727273,29.54545455,35.22727273,14,78.6,0.875,Seychelles-Division-One,2022/05/06,2022/04/07 14:30
7,Nrn Dynamo,11,2,2,7,3,29,4,0,1,3,1,9,7,2,1,4,2,20,8,-26,2.91,2.636363636,2.25,2.857142857,0.272727273,0.25,0.285714286,35.22727273,29.54545455,35.22727273,14,78.6,0.875,Seychelles-Division-One,2022/05/06,2022/04/28 14:30
8,Bazar Bro,10,0,2,8,3,19,5,0,1,4,2,9,5,0,1,4,1,10,2,-16,2.2,1.9,1.8,2,0.3,0.4,0.2,35.22727273,29.54545455,35.22727273,14,71.4,1,Seychelles-Division-One,2022/05/06,2022/04/07 14:30
8,Bazar Bro,10,0,2,8,3,19,5,0,1,4,2,9,5,0,1,4,1,10,2,-16,2.2,1.9,1.8,2,0.3,0.4,0.2,35.22727273,29.54545455,35.22727273,14,71.4,1,Seychelles-Division-One,2022/05/06,2022/04/21 14:30
8,Bazar Bro,10,0,2,8,3,19,5,0,1,4,2,9,5,0,1,4,1,10,2,-16,2.2,1.9,1.8,2,0.3,0.4,0.2,35.22727273,29.54545455,35.22727273,14,71.4,1,Seychelles-Division-One,2022/05/06,2022/04/29 14:30
8,Bazar Bro,10,0,2,8,3,19,5,0,1,4,2,9,5,0,1,4,1,10,2,-16,2.2,1.9,1.8,2,0.3,0.4,0.2,35.22727273,29.54545455,35.22727273,14,71.4,1,Seychelles-Division-One,2022/05/06,2022/05/07 13:00
1,Home,7,5,1,1,16,4,4,4,0,0,14,2,3,1,1,1,2,2,16,12,2.86,0.571428571,0.5,0.666666667,2.285714286,3.5,0.666666667,35.71428571,28.57142857,35.71428571,14,50,0.125,Singapore-Premier-League,2022/05/06,2022/04/09 13:30
1,Home,7,5,1,1,16,4,4,4,0,0,14,2,3,1,1,1,2,2,16,12,2.86,0.571428571,0.5,0.666666667,2.285714286,3.5,0.666666667,35.71428571,28.57142857,35.71428571,14,50,0.125,Singapore-Premier-League,2022/05/06,2022/04/06 13:30
1,Home,7,5,1,1,16,4,4,4,0,0,14,2,3,1,1,1,2,2,16,12,2.86,0.571428571,0.5,0.666666667,2.285714286,3.5,0.666666667,35.71428571,28.57142857,35.71428571,14,50,0.125,Singapore-Premier-League,2022/05/06,2022/05/06 12:45
2,Tampines,7,3,3,1,21,14,4,2,2,0,16,9,3,1,1,1,5,5,12,7,5,2,2.25,1.666666667,3,4,1.666666667,35.71428571,28.57142857,35.71428571,14,50,0.25,Singapore-Premier-League,2022/05/06,2022/04/06 13:30
2,Tampines,7,3,3,1,21,14,4,2,2,0,16,9,3,1,1,1,5,5,12,7,5,2,2.25,1.666666667,3,4,1.666666667,35.71428571,28.57142857,35.71428571,14,50,0.25,Singapore-Premier-League,2022/05/06,2022/04/09 13:30
2,Tampines,7,3,3,1,21,14,4,2,2,0,16,9,3,1,1,1,5,5,12,7,5,2,2.25,1.666666667,3,4,1.666666667,35.71428571,28.57142857,35.71428571,14,50,0.25,Singapore-Premier-League,2022/05/06,2022/04/20 13:30
2,Tampines,7,3,3,1,21,14,4,2,2,0,16,9,3,1,1,1,5,5,12,7,5,2,2.25,1.666666667,3,4,1.666666667,35.71428571,28.57142857,35.71428571,14,50,0.25,Singapore-Premier-League,2022/05/06,2022/05/08 10:30
2,Tampines,7,3,3,1,21,14,4,2,2,0,16,9,3,1,1,1,5,5,12,7,5,2,2.25,1.666666667,3,4,1.666666667,35.71428571,28.57142857,35.71428571,14,50,0.25,Singapore-Premier-League,2022/05/06,2022/04/02 10:30
3,Tanjong,7,3,3,1,17,17,2,0,2,0,3,3,5,3,1,1,14,14,12,0,4.86,2.428571429,1.5,2.8,2.428571429,1.5,2.8,35.71428571,28.57142857,35.71428571,14,50,0.375,Singapore-Premier-League,2022/05/06,2022/05/07 10:30
3,Tanjong,7,3,3,1,17,17,2,0,2,0,3,3,5,3,1,1,14,14,12,0,4.86,2.428571429,1.5,2.8,2.428571429,1.5,2.8,35.71428571,28.57142857,35.71428571,14,50,0.375,Singapore-Premier-League,2022/05/06,2022/04/02 10:30
3,Tanjong,7,3,3,1,17,17,2,0,2,0,3,3,5,3,1,1,14,14,12,0,4.86,2.428571429,1.5,2.8,2.428571429,1.5,2.8,35.71428571,28.57142857,35.71428571,14,50,0.375,Singapore-Premier-League,2022/05/06,2022/04/06 13:30
3,Tanjong,7,3,3,1,17,17,2,0,2,0,3,3,5,3,1,1,14,14,12,0,4.86,2.428571429,1.5,2.8,2.428571429,1.5,2.8,35.71428571,28.57142857,35.71428571,14,50,0.375,Singapore-Premier-League,2022/05/06,2022/04/09 13:30
4,Albirex,7,2,4,1,18,9,3,1,1,1,7,3,4,1,3,0,11,6,10,9,3.86,1.285714286,1,1.5,2.571428571,2.333333333,2.75,35.71428571,28.57142857,35.71428571,14,50,0.5,Singapore-Premier-League,2022/05/06,2022/04/05 13:30
4,Albirex,7,2,4,1,18,9,3,1,1,1,7,3,4,1,3,0,11,6,10,9,3.86,1.285714286,1,1.5,2.571428571,2.333333333,2.75,35.71428571,28.57142857,35.71428571,14,50,0.5,Singapore-Premier-League,2022/05/06,2022/04/09 13:30
4,Albirex,7,2,4,1,18,9,3,1,1,1,7,3,4,1,3,0,11,6,10,9,3.86,1.285714286,1,1.5,2.571428571,2.333333333,2.75,35.71428571,28.57142857,35.71428571,14,50,0.5,Singapore-Premier-League,2022/05/06,2022/05/07 10:30
5,Balestier Kh,7,3,1,3,12,21,4,2,1,1,11,11,3,1,0,2,1,10,10,-9,4.71,3,2.75,3.333333333,1.714285714,2.75,0.333333333,35.71428571,28.57142857,35.71428571,14,50,0.625,Singapore-Premier-League,2022/05/06,2022/04/05 13:30
5,Balestier Kh,7,3,1,3,12,21,4,2,1,1,11,11,3,1,0,2,1,10,10,-9,4.71,3,2.75,3.333333333,1.714285714,2.75,0.333333333,35.71428571,28.57142857,35.71428571,14,50,0.625,Singapore-Premier-League,2022/05/06,2022/04/10 13:30
5,Balestier Kh,7,3,1,3,12,21,4,2,1,1,11,11,3,1,0,2,1,10,10,-9,4.71,3,2.75,3.333333333,1.714285714,2.75,0.333333333,35.71428571,28.57142857,35.71428571,14,50,0.625,Singapore-Premier-League,2022/05/06,2022/05/08 10:30
6,Hougang Utd,7,2,2,3,11,18,3,2,1,0,6,4,4,0,1,3,5,14,8,-7,4.14,2.571428571,1.333333333,3.5,1.571428571,2,1.25,35.71428571,28.57142857,35.71428571,14,50,0.75,Singapore-Premier-League,2022/05/06,2022/04/10 13:30
6,Hougang Utd,7,2,2,3,11,18,3,2,1,0,6,4,4,0,1,3,5,14,8,-7,4.14,2.571428571,1.333333333,3.5,1.571428571,2,1.25,35.71428571,28.57142857,35.71428571,14,50,0.75,Singapore-Premier-League,2022/05/06,2022/05/06 12:45
6,Hougang Utd,7,2,2,3,11,18,3,2,1,0,6,4,4,0,1,3,5,14,8,-7,4.14,2.571428571,1.333333333,3.5,1.571428571,2,1.25,35.71428571,28.57142857,35.71428571,14,50,0.75,Singapore-Premier-League,2022/05/06,2022/04/05 13:30
7,Geylang,7,1,2,4,9,14,4,1,1,2,5,6,3,0,1,2,4,8,5,-5,3.29,2,1.5,2.666666667,1.285714286,1.25,1.333333333,35.71428571,28.57142857,35.71428571,14,50,0.875,Singapore-Premier-League,2022/05/06,2022/04/02 10:30
7,Geylang,7,1,2,4,9,14,4,1,1,2,5,6,3,0,1,2,4,8,5,-5,3.29,2,1.5,2.666666667,1.285714286,1.25,1.333333333,35.71428571,28.57142857,35.71428571,14,50,0.875,Singapore-Premier-League,2022/05/06,2022/04/05 13:30
7,Geylang,7,1,2,4,9,14,4,1,1,2,5,6,3,0,1,2,4,8,5,-5,3.29,2,1.5,2.666666667,1.285714286,1.25,1.333333333,35.71428571,28.57142857,35.71428571,14,50,0.875,Singapore-Premier-League,2022/05/06,2022/04/10 13:30
7,Geylang,7,1,2,4,9,14,4,1,1,2,5,6,3,0,1,2,4,8,5,-5,3.29,2,1.5,2.666666667,1.285714286,1.25,1.333333333,35.71428571,28.57142857,35.71428571,14,50,0.875,Singapore-Premier-League,2022/05/06,2022/04/16 13:30
8,Young Lions,7,1,0,6,12,19,4,1,0,3,6,10,3,0,0,3,6,9,3,-7,4.43,2.714285714,2.5,3,1.714285714,1.5,2,35.71428571,28.57142857,35.71428571,14,50,1,Singapore-Premier-League,2022/05/06,2022/04/02 10:30
8,Young Lions,7,1,0,6,12,19,4,1,0,3,6,10,3,0,0,3,6,9,3,-7,4.43,2.714285714,2.5,3,1.714285714,1.5,2,35.71428571,28.57142857,35.71428571,14,50,1,Singapore-Premier-League,2022/05/06,2022/04/06 13:30
8,Young Lions,7,1,0,6,12,19,4,1,0,3,6,10,3,0,0,3,6,9,3,-7,4.43,2.714285714,2.5,3,1.714285714,1.5,2,35.71428571,28.57142857,35.71428571,14,50,1,Singapore-Premier-League,2022/05/06,2022/04/16 13:30
8,Young Lions,7,1,0,6,12,19,4,1,0,3,6,10,3,0,0,3,6,9,3,-7,4.43,2.714285714,2.5,3,1.714285714,1.5,2,35.71428571,28.57142857,35.71428571,14,50,1,Singapore-Premier-League,2022/05/06,2022/04/10 13:30
8,Young Lions,7,1,0,6,12,19,4,1,0,3,6,10,3,0,0,3,6,9,3,-7,4.43,2.714285714,2.5,3,1.714285714,1.5,2,35.71428571,28.57142857,35.71428571,14,50,1,Singapore-Premier-League,2022/05/06,2022/04/20 13:30
1,Podbrezova,27,21,2,4,72,20,14,11,0,3,44,12,13,10,2,1,28,8,65,52,3.41,0.740740741,0.857142857,0.615384615,2.666666667,3.142857143,2.153846154,40.27777778,19.44444444,40.27777778,30,90,0.0625,Slovakia-2-Liga,2022/05/06,2022/04/29 16:00
1,Podbrezova,27,21,2,4,72,20,14,11,0,3,44,12,13,10,2,1,28,8,65,52,3.41,0.740740741,0.857142857,0.615384615,2.666666667,3.142857143,2.153846154,40.27777778,19.44444444,40.27777778,30,90,0.0625,Slovakia-2-Liga,2022/05/06,2022/05/07 12:00
2,B.Bystrica,27,19,5,3,54,21,14,11,2,1,34,13,13,8,3,2,20,8,62,33,2.78,0.777777778,0.928571429,0.615384615,2,2.428571429,1.538461538,40.27777778,19.44444444,40.27777778,30,90,0.125,Slovakia-2-Liga,2022/05/06,2022/04/30 15:00
2,B.Bystrica,27,19,5,3,54,21,14,11,2,1,34,13,13,8,3,2,20,8,62,33,2.78,0.777777778,0.928571429,0.615384615,2,2.428571429,1.538461538,40.27777778,19.44444444,40.27777778,30,90,0.125,Slovakia-2-Liga,2022/05/06,2022/05/06 15:00
3,Skalica,27,17,5,5,42,18,14,10,2,2,25,6,13,7,3,3,17,12,56,24,2.22,0.666666667,0.428571429,0.923076923,1.555555556,1.785714286,1.307692308,40.27777778,19.44444444,40.27777778,30,90,0.1875,Slovakia-2-Liga,2022/05/06,2022/04/30 17:00
3,Skalica,27,17,5,5,42,18,14,10,2,2,25,6,13,7,3,3,17,12,56,24,2.22,0.666666667,0.428571429,0.923076923,1.555555556,1.785714286,1.307692308,40.27777778,19.44444444,40.27777778,30,90,0.1875,Slovakia-2-Liga,2022/05/06,2022/05/07 16:00
4,Komarno,27,14,8,5,39,28,13,7,4,2,17,11,14,7,4,3,22,17,50,11,2.48,1.037037037,0.846153846,1.214285714,1.444444444,1.307692308,1.571428571,40.27777778,19.44444444,40.27777778,30,90,0.25,Slovakia-2-Liga,2022/05/06,2022/05/07 16:00
5,FK Humenne,27,14,8,5,30,24,13,9,2,2,17,10,14,5,6,3,13,14,50,6,2,0.888888889,0.769230769,1,1.111111111,1.307692308,0.928571429,40.27777778,19.44444444,40.27777778,30,90,0.3125,Slovakia-2-Liga,2022/05/06,2022/05/07 16:00
5,FK Humenne,27,14,8,5,30,24,13,9,2,2,17,10,14,5,6,3,13,14,50,6,2,0.888888889,0.769230769,1,1.111111111,1.307692308,0.928571429,40.27777778,19.44444444,40.27777778,30,90,0.3125,Slovakia-2-Liga,2022/05/06,2022/04/30 15:30
6,1 FC Kosice,27,14,4,9,64,38,13,6,3,4,25,15,14,8,1,5,39,23,46,26,3.78,1.407407407,1.153846154,1.642857143,2.37037037,1.923076923,2.785714286,40.27777778,19.44444444,40.27777778,30,90,0.375,Slovakia-2-Liga,2022/05/06,2022/04/29 17:00
6,1 FC Kosice,27,14,4,9,64,38,13,6,3,4,25,15,14,8,1,5,39,23,46,26,3.78,1.407407407,1.153846154,1.642857143,2.37037037,1.923076923,2.785714286,40.27777778,19.44444444,40.27777778,30,90,0.375,Slovakia-2-Liga,2022/05/06,2022/05/07 17:00
7,Samorin,27,12,4,11,42,37,14,7,2,5,28,15,13,5,2,6,14,22,40,5,2.93,1.37037037,1.071428571,1.692307692,1.555555556,2,1.076923077,40.27777778,19.44444444,40.27777778,30,90,0.4375,Slovakia-2-Liga,2022/05/06,2022/05/01 09:30
7,Samorin,27,12,4,11,42,37,14,7,2,5,28,15,13,5,2,6,14,22,40,5,2.93,1.37037037,1.071428571,1.692307692,1.555555556,2,1.076923077,40.27777778,19.44444444,40.27777778,30,90,0.4375,Slovakia-2-Liga,2022/05/06,2022/05/07 16:00
8,Zilina B,27,10,6,11,41,40,13,7,3,3,32,17,14,3,3,8,9,23,36,1,3,1.481481481,1.307692308,1.642857143,1.518518519,2.461538462,0.642857143,40.27777778,19.44444444,40.27777778,30,90,0.5,Slovakia-2-Liga,2022/05/06,2022/05/07 12:00
8,Zilina B,27,10,6,11,41,40,13,7,3,3,32,17,14,3,3,8,9,23,36,1,3,1.481481481,1.307692308,1.642857143,1.518518519,2.461538462,0.642857143,40.27777778,19.44444444,40.27777778,30,90,0.5,Slovakia-2-Liga,2022/05/06,2022/04/30 17:00
9,Petrzalka,27,10,5,12,45,41,13,5,3,5,27,20,14,5,2,7,18,21,35,4,3.19,1.518518519,1.538461538,1.5,1.666666667,2.076923077,1.285714286,40.27777778,19.44444444,40.27777778,30,90,0.5625,Slovakia-2-Liga,2022/05/06,2022/05/08 09:30
9,Petrzalka,27,10,5,12,45,41,13,5,3,5,27,20,14,5,2,7,18,21,35,4,3.19,1.518518519,1.538461538,1.5,1.666666667,2.076923077,1.285714286,40.27777778,19.44444444,40.27777778,30,90,0.5625,Slovakia-2-Liga,2022/05/06,2022/05/01 09:30
10,Slavoj Trebis,27,8,7,12,24,44,13,6,4,3,16,16,14,2,3,9,8,28,31,-20,2.52,1.62962963,1.230769231,2,0.888888889,1.230769231,0.571428571,40.27777778,19.44444444,40.27777778,30,90,0.625,Slovakia-2-Liga,2022/05/06,2022/05/07 16:00
10,Slavoj Trebis,27,8,7,12,24,44,13,6,4,3,16,16,14,2,3,9,8,28,31,-20,2.52,1.62962963,1.230769231,2,0.888888889,1.230769231,0.571428571,40.27777778,19.44444444,40.27777778,30,90,0.625,Slovakia-2-Liga,2022/05/06,2022/04/29 17:00
11,Dubnica,27,8,6,13,33,45,14,5,2,7,19,17,13,3,4,6,14,28,30,-12,2.89,1.666666667,1.214285714,2.153846154,1.222222222,1.357142857,1.076923077,40.27777778,19.44444444,40.27777778,30,90,0.6875,Slovakia-2-Liga,2022/05/06,2022/04/29 16:00
11,Dubnica,27,8,6,13,33,45,14,5,2,7,19,17,13,3,4,6,14,28,30,-12,2.89,1.666666667,1.214285714,2.153846154,1.222222222,1.357142857,1.076923077,40.27777778,19.44444444,40.27777778,30,90,0.6875,Slovakia-2-Liga,2022/05/06,2022/05/07 17:00
12,Rohoznik,27,7,5,15,26,51,14,3,4,7,14,26,13,4,1,8,12,25,26,-25,2.85,1.888888889,1.857142857,1.923076923,0.962962963,1,0.923076923,40.27777778,19.44444444,40.27777778,30,90,0.75,Slovakia-2-Liga,2022/05/06,2022/04/30 15:00
12,Rohoznik,27,7,5,15,26,51,14,3,4,7,14,26,13,4,1,8,12,25,26,-25,2.85,1.888888889,1.857142857,1.923076923,0.962962963,1,0.923076923,40.27777778,19.44444444,40.27777778,30,90,0.75,Slovakia-2-Liga,2022/05/06,2022/05/07 16:00
13,Puchov,27,7,4,16,33,46,14,4,2,8,15,20,13,3,2,8,18,26,25,-13,2.93,1.703703704,1.428571429,2,1.222222222,1.071428571,1.384615385,40.27777778,19.44444444,40.27777778,30,90,0.8125,Slovakia-2-Liga,2022/05/06,2022/05/08 09:30
14,Slov Brat 2,27,7,4,16,33,54,13,5,3,5,20,20,14,2,1,11,13,34,25,-21,3.22,2,1.538461538,2.428571429,1.222222222,1.538461538,0.928571429,40.27777778,19.44444444,40.27777778,30,90,0.875,Slovakia-2-Liga,2022/05/06,2022/05/06 15:00
14,Slov Brat 2,27,7,4,16,33,54,13,5,3,5,20,20,14,2,1,11,13,34,25,-21,3.22,2,1.538461538,2.428571429,1.222222222,1.538461538,0.928571429,40.27777778,19.44444444,40.27777778,30,90,0.875,Slovakia-2-Liga,2022/05/06,2022/04/30 15:00
15,P Bardejov,27,4,8,15,26,39,13,3,3,7,13,16,14,1,5,8,13,23,20,-13,2.41,1.444444444,1.230769231,1.642857143,0.962962963,1,0.928571429,40.27777778,19.44444444,40.27777778,30,90,0.9375,Slovakia-2-Liga,2022/05/06,2022/05/07 16:00
15,P Bardejov,27,4,8,15,26,39,13,3,3,7,13,16,14,1,5,8,13,23,20,-13,2.41,1.444444444,1.230769231,1.642857143,0.962962963,1,0.928571429,40.27777778,19.44444444,40.27777778,30,90,0.9375,Slovakia-2-Liga,2022/05/06,2022/04/30 15:00
16,Namestovo,27,2,3,22,18,76,14,2,3,9,10,32,13,0,0,13,8,44,9,-58,3.48,2.814814815,2.285714286,3.384615385,0.666666667,0.714285714,0.615384615,40.27777778,19.44444444,40.27777778,30,90,1,Slovakia-2-Liga,2022/05/06,2022/04/30 15:30
16,Namestovo,27,2,3,22,18,76,14,2,3,9,10,32,13,0,0,13,8,44,9,-58,3.48,2.814814815,2.285714286,3.384615385,0.666666667,0.714285714,0.615384615,40.27777778,19.44444444,40.27777778,30,90,1,Slovakia-2-Liga,2022/05/06,2022/05/07 16:00
1,Maribor,33,19,7,7,50,32,17,10,5,2,23,8,16,9,2,5,27,24,64,18,2.48,0.96969697,0.470588235,1.5,1.515151515,1.352941176,1.6875,36.96969697,26.06060606,36.96969697,18,183.3,0.1,Slovenia-1-SNL,2022/05/06,2022/04/30 19:15
1,Maribor,33,19,7,7,50,32,17,10,5,2,23,8,16,9,2,5,27,24,64,18,2.48,0.96969697,0.470588235,1.5,1.515151515,1.352941176,1.6875,36.96969697,26.06060606,36.96969697,18,183.3,0.1,Slovenia-1-SNL,2022/05/06,2022/04/23 16:30
1,Maribor,33,19,7,7,50,32,17,10,5,2,23,8,16,9,2,5,27,24,64,18,2.48,0.96969697,0.470588235,1.5,1.515151515,1.352941176,1.6875,36.96969697,26.06060606,36.96969697,18,183.3,0.1,Slovenia-1-SNL,2022/05/06,2022/05/07 16:30
2,Koper,33,18,9,6,52,35,16,8,3,5,25,20,17,10,6,1,27,15,63,17,2.64,1.060606061,1.25,0.882352941,1.575757576,1.5625,1.588235294,36.96969697,26.06060606,36.96969697,18,183.3,0.2,Slovenia-1-SNL,2022/05/06,2022/04/24 19:15
2,Koper,33,18,9,6,52,35,16,8,3,5,25,20,17,10,6,1,27,15,63,17,2.64,1.060606061,1.25,0.882352941,1.575757576,1.5625,1.588235294,36.96969697,26.06060606,36.96969697,18,183.3,0.2,Slovenia-1-SNL,2022/05/06,2022/05/06 19:15
2,Koper,33,18,9,6,52,35,16,8,3,5,25,20,17,10,6,1,27,15,63,17,2.64,1.060606061,1.25,0.882352941,1.575757576,1.5625,1.588235294,36.96969697,26.06060606,36.96969697,18,183.3,0.2,Slovenia-1-SNL,2022/05/06,2022/04/30 19:15
3,Olimpija,33,16,7,10,45,33,17,11,3,3,33,18,16,5,4,7,12,15,55,12,2.36,1,1.058823529,0.9375,1.363636364,1.941176471,0.75,36.96969697,26.06060606,36.96969697,18,183.3,0.3,Slovenia-1-SNL,2022/05/06,2022/05/01 19:15
3,Olimpija,33,16,7,10,45,33,17,11,3,3,33,18,16,5,4,7,12,15,55,12,2.36,1,1.058823529,0.9375,1.363636364,1.941176471,0.75,36.96969697,26.06060606,36.96969697,18,183.3,0.3,Slovenia-1-SNL,2022/05/06,2022/04/24 19:15
3,Olimpija,33,16,7,10,45,33,17,11,3,3,33,18,16,5,4,7,12,15,55,12,2.36,1,1.058823529,0.9375,1.363636364,1.941176471,0.75,36.96969697,26.06060606,36.96969697,18,183.3,0.3,Slovenia-1-SNL,2022/05/06,2022/05/08 19:15
4,Mura,33,14,11,8,50,43,16,9,4,3,27,20,17,5,7,5,23,23,53,7,2.82,1.303030303,1.25,1.352941176,1.515151515,1.6875,1.352941176,36.96969697,26.06060606,36.96969697,18,183.3,0.4,Slovenia-1-SNL,2022/05/06,2022/05/08 16:30
4,Mura,33,14,11,8,50,43,16,9,4,3,27,20,17,5,7,5,23,23,53,7,2.82,1.303030303,1.25,1.352941176,1.515151515,1.6875,1.352941176,36.96969697,26.06060606,36.96969697,18,183.3,0.4,Slovenia-1-SNL,2022/05/06,2022/04/23 19:15
4,Mura,33,14,11,8,50,43,16,9,4,3,27,20,17,5,7,5,23,23,53,7,2.82,1.303030303,1.25,1.352941176,1.515151515,1.6875,1.352941176,36.96969697,26.06060606,36.96969697,18,183.3,0.4,Slovenia-1-SNL,2022/05/06,2022/04/29 19:15
5,Domzale,33,11,10,12,42,39,17,6,6,5,24,19,16,5,4,7,18,20,43,3,2.45,1.181818182,1.117647059,1.25,1.272727273,1.411764706,1.125,36.96969697,26.06060606,36.96969697,18,183.3,0.5,Slovenia-1-SNL,2022/05/06,2022/05/01 16:30
5,Domzale,33,11,10,12,42,39,17,6,6,5,24,19,16,5,4,7,18,20,43,3,2.45,1.181818182,1.117647059,1.25,1.272727273,1.411764706,1.125,36.96969697,26.06060606,36.96969697,18,183.3,0.5,Slovenia-1-SNL,2022/05/06,2022/04/24 14:00
5,Domzale,33,11,10,12,42,39,17,6,6,5,24,19,16,5,4,7,18,20,43,3,2.45,1.181818182,1.117647059,1.25,1.272727273,1.411764706,1.125,36.96969697,26.06060606,36.96969697,18,183.3,0.5,Slovenia-1-SNL,2022/05/06,2022/05/08 16:30
6,NK Bravo,33,11,9,13,29,32,16,4,4,8,11,17,17,7,5,5,18,15,42,-3,1.85,0.96969697,1.0625,0.882352941,0.878787879,0.6875,1.058823529,36.96969697,26.06060606,36.96969697,18,183.3,0.6,Slovenia-1-SNL,2022/05/06,2022/04/24 14:00
6,NK Bravo,33,11,9,13,29,32,16,4,4,8,11,17,17,7,5,5,18,15,42,-3,1.85,0.96969697,1.0625,0.882352941,0.878787879,0.6875,1.058823529,36.96969697,26.06060606,36.96969697,18,183.3,0.6,Slovenia-1-SNL,2022/05/06,2022/05/07 16:30
6,NK Bravo,33,11,9,13,29,32,16,4,4,8,11,17,17,7,5,5,18,15,42,-3,1.85,0.96969697,1.0625,0.882352941,0.878787879,0.6875,1.058823529,36.96969697,26.06060606,36.96969697,18,183.3,0.6,Slovenia-1-SNL,2022/05/06,2022/05/01 19:15
7,NK Celje,33,12,5,16,44,45,17,8,4,5,23,19,16,4,1,11,21,26,41,-1,2.7,1.363636364,1.117647059,1.625,1.333333333,1.352941176,1.3125,36.96969697,26.06060606,36.96969697,18,183.3,0.7,Slovenia-1-SNL,2022/05/06,2022/04/29 19:15
7,NK Celje,33,12,5,16,44,45,17,8,4,5,23,19,16,4,1,11,21,26,41,-1,2.7,1.363636364,1.117647059,1.625,1.333333333,1.352941176,1.3125,36.96969697,26.06060606,36.96969697,18,183.3,0.7,Slovenia-1-SNL,2022/05/06,2022/04/25 16:30
7,NK Celje,33,12,5,16,44,45,17,8,4,5,23,19,16,4,1,11,21,26,41,-1,2.7,1.363636364,1.117647059,1.625,1.333333333,1.352941176,1.3125,36.96969697,26.06060606,36.96969697,18,183.3,0.7,Slovenia-1-SNL,2022/05/06,2022/05/07 14:00
8,Radomlje,33,10,9,14,39,47,16,3,5,8,17,28,17,7,4,6,22,19,39,-8,2.61,1.424242424,1.75,1.117647059,1.181818182,1.0625,1.294117647,36.96969697,26.06060606,36.96969697,18,183.3,0.8,Slovenia-1-SNL,2022/05/06,2022/04/23 19:15
8,Radomlje,33,10,9,14,39,47,16,3,5,8,17,28,17,7,4,6,22,19,39,-8,2.61,1.424242424,1.75,1.117647059,1.181818182,1.0625,1.294117647,36.96969697,26.06060606,36.96969697,18,183.3,0.8,Slovenia-1-SNL,2022/05/06,2022/05/07 14:00
8,Radomlje,33,10,9,14,39,47,16,3,5,8,17,28,17,7,4,6,22,19,39,-8,2.61,1.424242424,1.75,1.117647059,1.181818182,1.0625,1.294117647,36.96969697,26.06060606,36.96969697,18,183.3,0.8,Slovenia-1-SNL,2022/05/06,2022/04/30 16:30
9,Tabor,33,7,8,18,28,37,17,3,4,10,15,21,16,4,4,8,13,16,29,-9,1.97,1.121212121,1.235294118,1,0.848484848,0.882352941,0.8125,36.96969697,26.06060606,36.96969697,18,183.3,0.9,Slovenia-1-SNL,2022/05/06,2022/04/23 16:30
9,Tabor,33,7,8,18,28,37,17,3,4,10,15,21,16,4,4,8,13,16,29,-9,1.97,1.121212121,1.235294118,1,0.848484848,0.882352941,0.8125,36.96969697,26.06060606,36.96969697,18,183.3,0.9,Slovenia-1-SNL,2022/05/06,2022/04/30 16:30
9,Tabor,33,7,8,18,28,37,17,3,4,10,15,21,16,4,4,8,13,16,29,-9,1.97,1.121212121,1.235294118,1,0.848484848,0.882352941,0.8125,36.96969697,26.06060606,36.96969697,18,183.3,0.9,Slovenia-1-SNL,2022/05/06,2022/05/06 19:15
10,Aluminij,33,4,11,18,28,64,16,3,5,8,13,26,17,1,6,10,15,38,23,-36,2.79,1.939393939,1.625,2.235294118,0.848484848,0.8125,0.882352941,36.96969697,26.06060606,36.96969697,18,183.3,1,Slovenia-1-SNL,2022/05/06,2022/04/25 16:30
10,Aluminij,33,4,11,18,28,64,16,3,5,8,13,26,17,1,6,10,15,38,23,-36,2.79,1.939393939,1.625,2.235294118,0.848484848,0.8125,0.882352941,36.96969697,26.06060606,36.96969697,18,183.3,1,Slovenia-1-SNL,2022/05/06,2022/05/08 19:15
10,Aluminij,33,4,11,18,28,64,16,3,5,8,13,26,17,1,6,10,15,38,23,-36,2.79,1.939393939,1.625,2.235294118,0.848484848,0.8125,0.882352941,36.96969697,26.06060606,36.96969697,18,183.3,1,Slovenia-1-SNL,2022/05/06,2022/05/01 16:30
1,Mamelodi Sun,27,18,7,2,52,14,14,11,3,0,32,7,13,7,4,2,20,7,61,38,2.44,0.518518519,0.5,0.538461538,1.925925926,2.285714286,1.538461538,31.71296296,36.57407407,31.71296296,30,90,0.0625,South-Africa-Premier,2022/05/06,2022/05/03 16:30
1,Mamelodi Sun,27,18,7,2,52,14,14,11,3,0,32,7,13,7,4,2,20,7,61,38,2.44,0.518518519,0.5,0.538461538,1.925925926,2.285714286,1.538461538,31.71296296,36.57407407,31.71296296,30,90,0.0625,South-Africa-Premier,2022/05/06,2022/05/08 16:30
2,Royal AM,27,12,9,6,37,24,13,9,3,1,17,7,14,3,6,5,20,17,45,13,2.26,0.888888889,0.538461538,1.214285714,1.37037037,1.307692308,1.428571429,31.71296296,36.57407407,31.71296296,30,90,0.125,South-Africa-Premier,2022/05/06,2022/05/08 14:00
2,Royal AM,27,12,9,6,37,24,13,9,3,1,17,7,14,3,6,5,20,17,45,13,2.26,0.888888889,0.538461538,1.214285714,1.37037037,1.307692308,1.428571429,31.71296296,36.57407407,31.71296296,30,90,0.125,South-Africa-Premier,2022/05/06,2022/05/04 18:30
3,Cape Town Cy,27,11,12,4,30,23,13,7,5,1,20,13,14,4,7,3,10,10,45,7,1.96,0.851851852,1,0.714285714,1.111111111,1.538461538,0.714285714,31.71296296,36.57407407,31.71296296,30,90,0.1875,South-Africa-Premier,2022/05/06,2022/05/07 18:30
3,Cape Town Cy,27,11,12,4,30,23,13,7,5,1,20,13,14,4,7,3,10,10,45,7,1.96,0.851851852,1,0.714285714,1.111111111,1.538461538,0.714285714,31.71296296,36.57407407,31.71296296,30,90,0.1875,South-Africa-Premier,2022/05/06,2022/05/04 16:00
4,Kaizer Chiefs,27,12,6,9,30,23,13,6,2,5,16,12,14,6,4,4,14,11,42,7,1.96,0.851851852,0.923076923,0.785714286,1.111111111,1.230769231,1,31.71296296,36.57407407,31.71296296,30,90,0.25,South-Africa-Premier,2022/05/06,2022/05/03 18:30
4,Kaizer Chiefs,27,12,6,9,30,23,13,6,2,5,16,12,14,6,4,4,14,11,42,7,1.96,0.851851852,0.923076923,0.785714286,1.111111111,1.230769231,1,31.71296296,36.57407407,31.71296296,30,90,0.25,South-Africa-Premier,2022/05/06,2022/05/08 16:30
5,Stellenbosch,27,9,13,5,27,22,13,5,6,2,13,12,14,4,7,3,14,10,40,5,1.81,0.814814815,0.923076923,0.714285714,1,1,1,31.71296296,36.57407407,31.71296296,30,90,0.3125,South-Africa-Premier,2022/05/06,2022/05/07 16:00
5,Stellenbosch,27,9,13,5,27,22,13,5,6,2,13,12,14,4,7,3,14,10,40,5,1.81,0.814814815,0.923076923,0.714285714,1,1,1,31.71296296,36.57407407,31.71296296,30,90,0.3125,South-Africa-Premier,2022/05/06,2022/05/03 16:00
6,Orlando Pir,27,9,13,5,28,23,14,6,6,2,16,12,13,3,7,3,12,11,40,5,1.89,0.851851852,0.857142857,0.846153846,1.037037037,1.142857143,0.923076923,31.71296296,36.57407407,31.71296296,30,90,0.375,South-Africa-Premier,2022/05/06,2022/05/08 14:00
7,Amazulu Durb,27,8,15,4,23,20,13,4,9,0,11,6,14,4,6,4,12,14,39,3,1.59,0.740740741,0.461538462,1,0.851851852,0.846153846,0.857142857,31.71296296,36.57407407,31.71296296,30,90,0.4375,South-Africa-Premier,2022/05/06,2022/05/07 16:00
7,Amazulu Durb,27,8,15,4,23,20,13,4,9,0,11,6,14,4,6,4,12,14,39,3,1.59,0.740740741,0.461538462,1,0.851851852,0.846153846,0.857142857,31.71296296,36.57407407,31.71296296,30,90,0.4375,South-Africa-Premier,2022/05/06,2022/05/03 16:00
8,Supersport,27,9,9,9,31,27,13,6,2,5,17,14,14,3,7,4,14,13,36,4,2.15,1,1.076923077,0.928571429,1.148148148,1.307692308,1,31.71296296,36.57407407,31.71296296,30,90,0.5,South-Africa-Premier,2022/05/06,2022/05/03 16:00
8,Supersport,27,9,9,9,31,27,13,6,2,5,17,14,14,3,7,4,14,13,36,4,2.15,1,1.076923077,0.928571429,1.148148148,1.307692308,1,31.71296296,36.57407407,31.71296296,30,90,0.5,South-Africa-Premier,2022/05/06,2022/05/06 18:30
9,Gld Arrows,27,8,11,8,31,37,14,5,5,4,17,16,13,3,6,4,14,21,35,-6,2.52,1.37037037,1.142857143,1.615384615,1.148148148,1.214285714,1.076923077,31.71296296,36.57407407,31.71296296,30,90,0.5625,South-Africa-Premier,2022/05/06,2022/05/04 16:00
9,Gld Arrows,27,8,11,8,31,37,14,5,5,4,17,16,13,3,6,4,14,21,35,-6,2.52,1.37037037,1.142857143,1.615384615,1.148148148,1.214285714,1.076923077,31.71296296,36.57407407,31.71296296,30,90,0.5625,South-Africa-Premier,2022/05/06,2022/05/07 14:00
10,Sekhukhune,27,8,7,12,19,21,14,4,4,6,11,10,13,4,3,6,8,11,31,-2,1.48,0.777777778,0.714285714,0.846153846,0.703703704,0.785714286,0.615384615,31.71296296,36.57407407,31.71296296,30,90,0.625,South-Africa-Premier,2022/05/06,2022/05/03 16:30
10,Sekhukhune,27,8,7,12,19,21,14,4,4,6,11,10,13,4,3,6,8,11,31,-2,1.48,0.777777778,0.714285714,0.846153846,0.703703704,0.785714286,0.615384615,31.71296296,36.57407407,31.71296296,30,90,0.625,South-Africa-Premier,2022/05/06,2022/05/07 16:00
11,Marumo Gall,27,7,10,10,20,26,13,3,8,2,10,9,14,4,2,8,10,17,31,-6,1.7,0.962962963,0.692307692,1.214285714,0.740740741,0.769230769,0.714285714,31.71296296,36.57407407,31.71296296,30,90,0.6875,South-Africa-Premier,2022/05/06,2022/05/07 14:00
11,Marumo Gall,27,7,10,10,20,26,13,3,8,2,10,9,14,4,2,8,10,17,31,-6,1.7,0.962962963,0.692307692,1.214285714,0.740740741,0.769230769,0.714285714,31.71296296,36.57407407,31.71296296,30,90,0.6875,South-Africa-Premier,2022/05/06,2022/05/03 18:30
12,Maritzburg,27,6,9,12,19,28,14,5,4,5,10,12,13,1,5,7,9,16,27,-9,1.74,1.037037037,0.857142857,1.230769231,0.703703704,0.714285714,0.692307692,31.71296296,36.57407407,31.71296296,30,90,0.75,South-Africa-Premier,2022/05/06,2022/05/04 18:30
12,Maritzburg,27,6,9,12,19,28,14,5,4,5,10,12,13,1,5,7,9,16,27,-9,1.74,1.037037037,0.857142857,1.230769231,0.703703704,0.714285714,0.692307692,31.71296296,36.57407407,31.71296296,30,90,0.75,South-Africa-Premier,2022/05/06,2022/05/07 16:00
13,Chippa Utd,27,5,12,10,20,31,13,1,8,4,9,14,14,4,4,6,11,17,27,-11,1.89,1.148148148,1.076923077,1.214285714,0.740740741,0.692307692,0.785714286,31.71296296,36.57407407,31.71296296,30,90,0.8125,South-Africa-Premier,2022/05/06,2022/05/04 16:00
13,Chippa Utd,27,5,12,10,20,31,13,1,8,4,9,14,14,4,4,6,11,17,27,-11,1.89,1.148148148,1.076923077,1.214285714,0.740740741,0.692307692,0.785714286,31.71296296,36.57407407,31.71296296,30,90,0.8125,South-Africa-Premier,2022/05/06,2022/05/07 14:00
14,TS Galaxy,27,6,8,13,21,36,14,4,5,5,14,18,13,2,3,8,7,18,26,-15,2.11,1.333333333,1.285714286,1.384615385,0.777777778,1,0.538461538,31.71296296,36.57407407,31.71296296,30,90,0.875,South-Africa-Premier,2022/05/06,2022/05/07 18:30
15,Moroka Swal,27,4,11,12,18,32,14,2,5,7,12,21,13,2,6,5,6,11,23,-14,1.85,1.185185185,1.5,0.846153846,0.666666667,0.857142857,0.461538462,31.71296296,36.57407407,31.71296296,30,90,0.9375,South-Africa-Premier,2022/05/06,2022/05/03 16:00
15,Moroka Swal,27,4,11,12,18,32,14,2,5,7,12,21,13,2,6,5,6,11,23,-14,1.85,1.185185185,1.5,0.846153846,0.666666667,0.857142857,0.461538462,31.71296296,36.57407407,31.71296296,30,90,0.9375,South-Africa-Premier,2022/05/06,2022/05/06 18:30
16,Baroka,27,5,6,16,17,36,14,5,4,5,8,7,13,0,2,11,9,29,21,-19,1.96,1.333333333,0.5,2.230769231,0.62962963,0.571428571,0.692307692,31.71296296,36.57407407,31.71296296,30,90,1,South-Africa-Premier,2022/05/06,2022/05/04 16:00
16,Baroka,27,5,6,16,17,36,14,5,4,5,8,7,13,0,2,11,9,29,21,-19,1.96,1.333333333,0.5,2.230769231,0.62962963,0.571428571,0.692307692,31.71296296,36.57407407,31.71296296,30,90,1,South-Africa-Premier,2022/05/06,2022/05/07 14:00
1,Eibar,38,21,11,6,56,40,19,13,5,1,33,17,19,8,6,5,23,23,74,16,2.53,1.052631579,0.894736842,1.210526316,1.473684211,1.736842105,1.210526316,34.80861244,30.38277512,34.80861244,42,90.5,0.045454545,Spain-Segunda,2022/05/06,2022/05/08 15:00
2,Almeria,38,22,7,9,60,32,19,13,3,3,34,14,19,9,4,6,26,18,73,28,2.42,0.842105263,0.736842105,0.947368421,1.578947368,1.789473684,1.368421053,34.80861244,30.38277512,34.80861244,42,90.5,0.090909091,Spain-Segunda,2022/05/06,2022/05/07 17:15
3,Valladolid,38,20,9,9,62,42,19,12,4,3,35,15,19,8,5,6,27,27,69,20,2.74,1.105263158,0.789473684,1.421052632,1.631578947,1.842105263,1.421052632,34.80861244,30.38277512,34.80861244,42,90.5,0.136363636,Spain-Segunda,2022/05/06,2022/05/02 20:00
3,Valladolid,38,20,9,9,62,42,19,12,4,3,35,15,19,8,5,6,27,27,69,20,2.74,1.105263158,0.789473684,1.421052632,1.631578947,1.842105263,1.421052632,34.80861244,30.38277512,34.80861244,42,90.5,0.136363636,Spain-Segunda,2022/05/06,2022/05/08 15:00
4,Tenerife,38,19,9,10,51,31,19,9,5,5,26,14,19,10,4,5,25,17,66,20,2.16,0.815789474,0.736842105,0.894736842,1.342105263,1.368421053,1.315789474,34.80861244,30.38277512,34.80861244,42,90.5,0.181818182,Spain-Segunda,2022/05/06,2022/05/01 17:15
4,Tenerife,38,19,9,10,51,31,19,9,5,5,26,14,19,10,4,5,25,17,66,20,2.16,0.815789474,0.736842105,0.894736842,1.342105263,1.368421053,1.315789474,34.80861244,30.38277512,34.80861244,42,90.5,0.181818182,Spain-Segunda,2022/05/06,2022/05/09 20:00
5,Girona,38,19,7,12,54,39,19,12,3,4,34,15,19,7,4,8,20,24,64,15,2.45,1.026315789,0.789473684,1.263157895,1.421052632,1.789473684,1.052631579,34.80861244,30.38277512,34.80861244,42,90.5,0.227272727,Spain-Segunda,2022/05/06,2022/05/09 20:00
6,Real Oviedo,38,16,15,7,50,34,19,10,7,2,32,14,19,6,8,5,18,20,63,16,2.21,0.894736842,0.736842105,1.052631579,1.315789474,1.684210526,0.947368421,34.80861244,30.38277512,34.80861244,42,90.5,0.272727273,Spain-Segunda,2022/05/06,2022/05/07 17:15
7,Ponferradina,38,16,12,10,54,48,19,9,7,3,34,21,19,7,5,7,20,27,60,6,2.68,1.263157895,1.105263158,1.421052632,1.421052632,1.789473684,1.052631579,34.80861244,30.38277512,34.80861244,42,90.5,0.318181818,Spain-Segunda,2022/05/06,2022/05/01 17:15
7,Ponferradina,38,16,12,10,54,48,19,9,7,3,34,21,19,7,5,7,20,27,60,6,2.68,1.263157895,1.105263158,1.421052632,1.421052632,1.789473684,1.052631579,34.80861244,30.38277512,34.80861244,42,90.5,0.318181818,Spain-Segunda,2022/05/06,2022/05/07 20:00
8,Las Palmas,38,15,13,10,51,46,19,10,5,4,31,22,19,5,8,6,20,24,58,5,2.55,1.210526316,1.157894737,1.263157895,1.342105263,1.631578947,1.052631579,34.80861244,30.38277512,34.80861244,42,90.5,0.363636364,Spain-Segunda,2022/05/06,2022/05/06 20:00
9,Cartagena,38,16,4,18,55,55,19,12,1,6,37,20,19,4,3,12,18,35,52,0,2.89,1.447368421,1.052631579,1.842105263,1.447368421,1.947368421,0.947368421,34.80861244,30.38277512,34.80861244,42,90.5,0.409090909,Spain-Segunda,2022/05/06,2022/05/08 13:00
9,Cartagena,38,16,4,18,55,55,19,12,1,6,37,20,19,4,3,12,18,35,52,0,2.89,1.447368421,1.052631579,1.842105263,1.447368421,1.947368421,0.947368421,34.80861244,30.38277512,34.80861244,42,90.5,0.409090909,Spain-Segunda,2022/05/06,2022/05/01 17:15
10,Eivis Ibiza,38,12,15,11,49,49,19,6,9,4,28,22,19,6,6,7,21,27,51,0,2.58,1.289473684,1.157894737,1.421052632,1.289473684,1.473684211,1.105263158,34.80861244,30.38277512,34.80861244,42,90.5,0.454545455,Spain-Segunda,2022/05/06,2022/05/08 17:15
11,Huesca,38,12,14,12,45,37,19,6,8,5,19,14,19,6,6,7,26,23,50,8,2.16,0.973684211,0.736842105,1.210526316,1.184210526,1,1.368421053,34.80861244,30.38277512,34.80861244,42,90.5,0.5,Spain-Segunda,2022/05/06,2022/05/07 15:00
11,Huesca,38,12,14,12,45,37,19,6,8,5,19,14,19,6,6,7,26,23,50,8,2.16,0.973684211,0.736842105,1.210526316,1.184210526,1,1.368421053,34.80861244,30.38277512,34.80861244,42,90.5,0.5,Spain-Segunda,2022/05/06,2022/05/02 17:30
12,Burgos,38,14,8,16,38,37,19,10,5,4,26,11,19,4,3,12,12,26,50,1,1.97,0.973684211,0.578947368,1.368421053,1,1.368421053,0.631578947,34.80861244,30.38277512,34.80861244,42,90.5,0.545454545,Spain-Segunda,2022/05/06,2022/05/07 20:00
13,Leganes,38,12,13,13,43,46,19,7,8,4,23,20,19,5,5,9,20,26,49,-3,2.34,1.210526316,1.052631579,1.368421053,1.131578947,1.210526316,1.052631579,34.80861244,30.38277512,34.80861244,42,90.5,0.590909091,Spain-Segunda,2022/05/06,2022/05/02 17:30
13,Leganes,38,12,13,13,43,46,19,7,8,4,23,20,19,5,5,9,20,26,49,-3,2.34,1.210526316,1.052631579,1.368421053,1.131578947,1.210526316,1.052631579,34.80861244,30.38277512,34.80861244,42,90.5,0.590909091,Spain-Segunda,2022/05/06,2022/05/08 13:00
14,Zaragoza,38,10,19,9,33,39,19,6,10,3,15,12,19,4,9,6,18,27,49,-6,1.89,1.026315789,0.631578947,1.421052632,0.868421053,0.789473684,0.947368421,34.80861244,30.38277512,34.80861244,42,90.5,0.636363636,Spain-Segunda,2022/05/06,2022/05/08 17:15
15,Lugo,38,9,19,10,43,47,19,8,8,3,20,16,19,1,11,7,23,31,46,-4,2.37,1.236842105,0.842105263,1.631578947,1.131578947,1.052631579,1.210526316,34.80861244,30.38277512,34.80861244,42,90.5,0.681818182,Spain-Segunda,2022/05/06,2022/05/01 17:15
15,Lugo,38,9,19,10,43,47,19,8,8,3,20,16,19,1,11,7,23,31,46,-4,2.37,1.236842105,0.842105263,1.631578947,1.131578947,1.052631579,1.210526316,34.80861244,30.38277512,34.80861244,42,90.5,0.681818182,Spain-Segunda,2022/05/06,2022/05/08 17:15
16,Mirandes,38,13,7,18,49,58,19,10,2,7,34,28,19,3,5,11,15,30,46,-9,2.82,1.526315789,1.473684211,1.578947368,1.289473684,1.789473684,0.789473684,34.80861244,30.38277512,34.80861244,42,90.5,0.727272727,Spain-Segunda,2022/05/06,2022/05/06 20:00
17,Sp Gijon,38,10,11,17,40,45,19,7,3,9,22,22,19,3,8,8,18,23,41,-5,2.24,1.184210526,1.157894737,1.210526316,1.052631579,1.157894737,0.947368421,34.80861244,30.38277512,34.80861244,42,90.5,0.772727273,Spain-Segunda,2022/05/06,2022/05/07 15:00
18,Malaga,38,10,11,17,34,55,19,7,6,6,18,23,19,3,5,11,16,32,41,-21,2.34,1.447368421,1.210526316,1.684210526,0.894736842,0.947368421,0.842105263,34.80861244,30.38277512,34.80861244,42,90.5,0.818181818,Spain-Segunda,2022/05/06,2022/05/07 17:15
19,Amorebieta,38,7,16,15,42,55,19,6,8,5,27,25,19,1,8,10,15,30,37,-13,2.55,1.447368421,1.315789474,1.578947368,1.105263158,1.421052632,0.789473684,34.80861244,30.38277512,34.80861244,42,90.5,0.863636364,Spain-Segunda,2022/05/06,2022/05/07 17:15
20,R Sociedad B,38,9,10,19,38,53,19,4,4,11,18,28,19,5,6,8,20,25,37,-15,2.39,1.394736842,1.473684211,1.315789474,1,0.947368421,1.052631579,34.80861244,30.38277512,34.80861244,42,90.5,0.909090909,Spain-Segunda,2022/05/06,2022/05/02 20:00
20,R Sociedad B,38,9,10,19,38,53,19,4,4,11,18,28,19,5,6,8,20,25,37,-15,2.39,1.394736842,1.473684211,1.315789474,1,0.947368421,1.052631579,34.80861244,30.38277512,34.80861244,42,90.5,0.909090909,Spain-Segunda,2022/05/06,2022/05/07 15:00
21,Fuenlabrada,38,5,14,19,34,57,19,4,9,6,22,24,19,1,5,13,12,33,29,-23,2.39,1.5,1.263157895,1.736842105,0.894736842,1.157894737,0.631578947,34.80861244,30.38277512,34.80861244,42,90.5,0.954545455,Spain-Segunda,2022/05/06,2022/05/07 15:00
22,Alcorcon,38,4,10,24,32,68,19,2,7,10,16,32,19,2,3,14,16,36,22,-36,2.63,1.789473684,1.684210526,1.894736842,0.842105263,0.842105263,0.842105263,34.80861244,30.38277512,34.80861244,42,90.5,1,Spain-Segunda,2022/05/06,2022/05/08 17:15
1,Al Merreikh,11,8,3,0,22,5,4,4,0,0,8,1,7,4,3,0,14,4,27,17,2.45,0.454545455,0.25,0.571428571,2,2,2,33.18181818,33.63636364,33.18181818,30,36.7,0.0625,Sudan-Premier,2022/05/06,2022/04/16 17:30
1,Al Merreikh,11,8,3,0,22,5,4,4,0,0,8,1,7,4,3,0,14,4,27,17,2.45,0.454545455,0.25,0.571428571,2,2,2,33.18181818,33.63636364,33.18181818,30,36.7,0.0625,Sudan-Premier,2022/05/06,2022/04/19 21:00
1,Al Merreikh,11,8,3,0,22,5,4,4,0,0,8,1,7,4,3,0,14,4,27,17,2.45,0.454545455,0.25,0.571428571,2,2,2,33.18181818,33.63636364,33.18181818,30,36.7,0.0625,Sudan-Premier,2022/05/06,2022/05/06 17:30
1,Al Merreikh,11,8,3,0,22,5,4,4,0,0,8,1,7,4,3,0,14,4,27,17,2.45,0.454545455,0.25,0.571428571,2,2,2,33.18181818,33.63636364,33.18181818,30,36.7,0.0625,Sudan-Premier,2022/05/06,2022/04/13 20:00
1,Al Merreikh,11,8,3,0,22,5,4,4,0,0,8,1,7,4,3,0,14,4,27,17,2.45,0.454545455,0.25,0.571428571,2,2,2,33.18181818,33.63636364,33.18181818,30,36.7,0.0625,Sudan-Premier,2022/05/06,2022/04/22 20:30
1,Al Merreikh,11,8,3,0,22,5,4,4,0,0,8,1,7,4,3,0,14,4,27,17,2.45,0.454545455,0.25,0.571428571,2,2,2,33.18181818,33.63636364,33.18181818,30,36.7,0.0625,Sudan-Premier,2022/05/06,2022/04/25 20:30
1,Al Merreikh,11,8,3,0,22,5,4,4,0,0,8,1,7,4,3,0,14,4,27,17,2.45,0.454545455,0.25,0.571428571,2,2,2,33.18181818,33.63636364,33.18181818,30,36.7,0.0625,Sudan-Premier,2022/05/06,2022/04/28 20:30
1,Al Merreikh,11,8,3,0,22,5,4,4,0,0,8,1,7,4,3,0,14,4,27,17,2.45,0.454545455,0.25,0.571428571,2,2,2,33.18181818,33.63636364,33.18181818,30,36.7,0.0625,Sudan-Premier,2022/05/06,2022/05/09 13:30
2,Al Hilal Omd,9,8,1,0,16,4,3,2,1,0,5,2,6,6,0,0,11,2,25,12,2.22,0.444444444,0.666666667,0.333333333,1.777777778,1.666666667,1.833333333,33.18181818,33.63636364,33.18181818,30,30,0.125,Sudan-Premier,2022/05/06,2022/04/12 17:00
2,Al Hilal Omd,9,8,1,0,16,4,3,2,1,0,5,2,6,6,0,0,11,2,25,12,2.22,0.444444444,0.666666667,0.333333333,1.777777778,1.666666667,1.833333333,33.18181818,33.63636364,33.18181818,30,30,0.125,Sudan-Premier,2022/05/06,2022/04/18 20:00
2,Al Hilal Omd,9,8,1,0,16,4,3,2,1,0,5,2,6,6,0,0,11,2,25,12,2.22,0.444444444,0.666666667,0.333333333,1.777777778,1.666666667,1.833333333,33.18181818,33.63636364,33.18181818,30,30,0.125,Sudan-Premier,2022/05/06,2022/05/06 13:30
2,Al Hilal Omd,9,8,1,0,16,4,3,2,1,0,5,2,6,6,0,0,11,2,25,12,2.22,0.444444444,0.666666667,0.333333333,1.777777778,1.666666667,1.833333333,33.18181818,33.63636364,33.18181818,30,30,0.125,Sudan-Premier,2022/05/06,2022/04/24 20:30
2,Al Hilal Omd,9,8,1,0,16,4,3,2,1,0,5,2,6,6,0,0,11,2,25,12,2.22,0.444444444,0.666666667,0.333333333,1.777777778,1.666666667,1.833333333,33.18181818,33.63636364,33.18181818,30,30,0.125,Sudan-Premier,2022/05/06,2022/04/27 20:30
2,Al Hilal Omd,9,8,1,0,16,4,3,2,1,0,5,2,6,6,0,0,11,2,25,12,2.22,0.444444444,0.666666667,0.333333333,1.777777778,1.666666667,1.833333333,33.18181818,33.63636364,33.18181818,30,30,0.125,Sudan-Premier,2022/05/06,2022/04/30 20:30
2,Al Hilal Omd,9,8,1,0,16,4,3,2,1,0,5,2,6,6,0,0,11,2,25,12,2.22,0.444444444,0.666666667,0.333333333,1.777777778,1.666666667,1.833333333,33.18181818,33.63636364,33.18181818,30,30,0.125,Sudan-Premier,2022/05/06,2022/05/10 17:30
3,Ahli Shendi,14,7,3,4,10,8,6,3,1,2,4,3,8,4,2,2,6,5,24,2,1.29,0.571428571,0.5,0.625,0.714285714,0.666666667,0.75,33.18181818,33.63636364,33.18181818,30,46.7,0.1875,Sudan-Premier,2022/05/06,2022/04/18 20:00
4,Al Hilal Sud,15,6,5,4,16,13,7,1,4,2,4,5,8,5,1,2,12,8,23,3,1.93,0.866666667,0.714285714,1,1.066666667,0.571428571,1.5,33.18181818,33.63636364,33.18181818,30,50,0.25,Sudan-Premier,2022/05/06,2022/04/30 20:30
5,Ahli Khartoum,15,5,6,4,11,11,8,4,2,2,8,5,7,1,4,2,3,6,21,0,1.47,0.733333333,0.625,0.857142857,0.733333333,1,0.428571429,33.18181818,33.63636364,33.18181818,30,50,0.3125,Sudan-Premier,2022/05/06,2022/04/28 20:30
6,Al Ahly Mero,14,5,5,4,18,17,6,3,1,2,7,6,8,2,4,2,11,11,20,1,2.5,1.214285714,1,1.375,1.285714286,1.166666667,1.375,33.18181818,33.63636364,33.18181818,30,46.7,0.375,Sudan-Premier,2022/05/06,
7,Hilal Fasher,14,5,5,4,12,11,9,4,3,2,10,7,5,1,2,2,2,4,20,1,1.64,0.785714286,0.777777778,0.8,0.857142857,1.111111111,0.4,33.18181818,33.63636364,33.18181818,30,46.7,0.4375,Sudan-Premier,2022/05/06,2022/04/22 20:30
8,Amal Atbara,15,4,7,4,13,15,9,3,4,2,9,9,6,1,3,2,4,6,19,-2,1.87,1,1,1,0.866666667,1,0.666666667,33.18181818,33.63636364,33.18181818,30,50,0.5,Sudan-Premier,2022/05/06,2022/04/12 17:00
9,Wad Nobawi,15,4,6,5,12,14,8,3,4,1,8,6,7,1,2,4,4,8,18,-2,1.73,0.933333333,0.75,1.142857143,0.8,1,0.571428571,33.18181818,33.63636364,33.18181818,30,50,0.5625,Sudan-Premier,2022/05/06,2022/04/24 20:30
9,Wad Nobawi,15,4,6,5,12,14,8,3,4,1,8,6,7,1,2,4,4,8,18,-2,1.73,0.933333333,0.75,1.142857143,0.8,1,0.571428571,33.18181818,33.63636364,33.18181818,30,50,0.5625,Sudan-Premier,2022/05/06,2022/04/16 17:30
10,Tuti,13,4,5,4,10,10,7,1,4,2,4,5,6,3,1,2,6,5,17,0,1.54,0.769230769,0.714285714,0.833333333,0.769230769,0.571428571,1,33.18181818,33.63636364,33.18181818,30,43.3,0.625,Sudan-Premier,2022/05/06,2022/05/10 17:30
10,Tuti,13,4,5,4,10,10,7,1,4,2,4,5,6,3,1,2,6,5,17,0,1.54,0.769230769,0.714285714,0.833333333,0.769230769,0.571428571,1,33.18181818,33.63636364,33.18181818,30,43.3,0.625,Sudan-Premier,2022/05/06,2022/04/19 21:00
11,Hay Al Arab,14,3,7,4,11,10,7,1,2,4,5,8,7,2,5,0,6,2,16,1,1.5,0.714285714,1.142857143,0.285714286,0.785714286,0.714285714,0.857142857,33.18181818,33.63636364,33.18181818,30,46.7,0.6875,Sudan-Premier,2022/05/06,2022/05/06 17:30
12,Al Shorta Sud,15,3,6,6,13,17,8,3,3,2,9,9,7,0,3,4,4,8,15,-4,2,1.133333333,1.125,1.142857143,0.866666667,1.125,0.571428571,33.18181818,33.63636364,33.18181818,30,50,0.75,Sudan-Premier,2022/05/06,
13,Kober,14,3,5,6,11,17,6,1,3,2,5,7,8,2,2,4,6,10,14,-6,2,1.214285714,1.166666667,1.25,0.785714286,0.833333333,0.75,33.18181818,33.63636364,33.18181818,30,46.7,0.8125,Sudan-Premier,2022/05/06,2022/04/27 20:30
13,Kober,14,3,5,6,11,17,6,1,3,2,5,7,8,2,2,4,6,10,14,-6,2,1.214285714,1.166666667,1.25,0.785714286,0.833333333,0.75,33.18181818,33.63636364,33.18181818,30,46.7,0.8125,Sudan-Premier,2022/05/06,2022/05/09 13:30
14,Al Wadi,13,3,4,6,12,15,6,1,3,2,6,8,7,2,1,4,6,7,13,-3,2.08,1.153846154,1.333333333,1,0.923076923,1,0.857142857,33.18181818,33.63636364,33.18181818,30,43.3,0.875,Sudan-Premier,2022/05/06,2022/04/13 20:00
15,Hilal El Obd,15,3,3,9,9,19,8,2,1,5,4,11,7,1,2,4,5,8,12,-10,1.87,1.266666667,1.375,1.142857143,0.6,0.5,0.714285714,33.18181818,33.63636364,33.18181818,30,50,0.9375,Sudan-Premier,2022/05/06,2022/04/25 20:30
16,Al Khartoum,14,2,3,9,15,25,8,1,1,6,7,16,6,1,2,3,8,9,9,-10,2.86,1.785714286,2,1.5,1.071428571,0.875,1.333333333,33.18181818,33.63636364,33.18181818,30,46.7,1,Sudan-Premier,2022/05/06,2022/05/06 13:30
1,Gefle,5,4,0,1,7,4,3,2,0,1,3,2,2,2,0,0,4,2,12,3,2.2,0.8,0.666666667,1,1.4,1,2,36.25,27.5,36.25,30,16.7,0.0625,Sweden-Div-1-North,2022/05/06,2022/04/30 15:00
1,Gefle,5,4,0,1,7,4,3,2,0,1,3,2,2,2,0,0,4,2,12,3,2.2,0.8,0.666666667,1,1.4,1,2,36.25,27.5,36.25,30,16.7,0.0625,Sweden-Div-1-North,2022/05/06,2022/05/08 15:00
2,Sandvikens IF,5,3,1,1,12,5,3,2,1,0,8,2,2,1,0,1,4,3,10,7,3.4,1,0.666666667,1.5,2.4,2.666666667,2,36.25,27.5,36.25,30,16.7,0.125,Sweden-Div-1-North,2022/05/06,2022/05/08 16:00
2,Sandvikens IF,5,3,1,1,12,5,3,2,1,0,8,2,2,1,0,1,4,3,10,7,3.4,1,0.666666667,1.5,2.4,2.666666667,2,36.25,27.5,36.25,30,16.7,0.125,Sweden-Div-1-North,2022/05/06,2022/04/30 15:00
3,Stock Inter,5,3,1,1,11,5,2,1,0,1,6,3,3,2,1,0,5,2,10,6,3.2,1,1.5,0.666666667,2.2,3,1.666666667,36.25,27.5,36.25,30,16.7,0.1875,Sweden-Div-1-North,2022/05/06,2022/05/09 18:00
3,Stock Inter,5,3,1,1,11,5,2,1,0,1,6,3,3,2,1,0,5,2,10,6,3.2,1,1.5,0.666666667,2.2,3,1.666666667,36.25,27.5,36.25,30,16.7,0.1875,Sweden-Div-1-North,2022/05/06,2022/05/01 16:00
4,Sylvia,5,2,3,0,9,5,2,1,1,0,3,0,3,1,2,0,6,5,9,4,2.8,1,0,1.666666667,1.8,1.5,2,36.25,27.5,36.25,30,16.7,0.25,Sweden-Div-1-North,2022/05/06,2022/05/08 15:00
4,Sylvia,5,2,3,0,9,5,2,1,1,0,3,0,3,1,2,0,6,5,9,4,2.8,1,0,1.666666667,1.8,1.5,2,36.25,27.5,36.25,30,16.7,0.25,Sweden-Div-1-North,2022/05/06,2022/04/30 13:00
5,Taby,5,3,0,2,12,9,2,1,0,1,4,3,3,2,0,1,8,6,9,3,4.2,1.8,1.5,2,2.4,2,2.666666667,36.25,27.5,36.25,30,16.7,0.3125,Sweden-Div-1-North,2022/05/06,2022/05/06 18:00
5,Taby,5,3,0,2,12,9,2,1,0,1,4,3,3,2,0,1,8,6,9,3,4.2,1.8,1.5,2,2.4,2,2.666666667,36.25,27.5,36.25,30,16.7,0.3125,Sweden-Div-1-North,2022/05/06,2022/05/01 13:00
6,Karlstad,5,2,2,1,12,6,2,1,0,1,5,4,3,1,2,0,7,2,8,6,3.6,1.2,2,0.666666667,2.4,2.5,2.333333333,36.25,27.5,36.25,30,16.7,0.375,Sweden-Div-1-North,2022/05/06,2022/05/08 15:00
6,Karlstad,5,2,2,1,12,6,2,1,0,1,5,4,3,1,2,0,7,2,8,6,3.6,1.2,2,0.666666667,2.4,2.5,2.333333333,36.25,27.5,36.25,30,16.7,0.375,Sweden-Div-1-North,2022/05/06,2022/04/30 12:00
7,Orebro Syr,5,2,2,1,9,6,3,1,2,0,5,3,2,1,0,1,4,3,8,3,3,1.2,1,1.5,1.8,1.666666667,2,36.25,27.5,36.25,30,16.7,0.4375,Sweden-Div-1-North,2022/05/06,2022/05/08 12:00
8,Haninge,5,2,2,1,5,3,3,1,1,1,3,3,2,1,1,0,2,0,8,2,1.6,0.6,1,0,1,1,1,36.25,27.5,36.25,30,16.7,0.5,Sweden-Div-1-North,2022/05/06,2022/04/30 15:00
8,Haninge,5,2,2,1,5,3,3,1,1,1,3,3,2,1,1,0,2,0,8,2,1.6,0.6,1,0,1,1,1,36.25,27.5,36.25,30,16.7,0.5,Sweden-Div-1-North,2022/05/06,2022/05/09 18:00
9,Umea,5,2,1,2,7,4,3,1,0,2,4,3,2,1,1,0,3,1,7,3,2.2,0.8,1,0.5,1.4,1.333333333,1.5,36.25,27.5,36.25,30,16.7,0.5625,Sweden-Div-1-North,2022/05/06,2022/05/01 16:00
9,Umea,5,2,1,2,7,4,3,1,0,2,4,3,2,1,1,0,3,1,7,3,2.2,0.8,1,0.5,1.4,1.333333333,1.5,36.25,27.5,36.25,30,16.7,0.5625,Sweden-Div-1-North,2022/05/06,2022/05/08 15:00
10,Motala,5,2,0,3,7,8,2,2,0,0,6,0,3,0,0,3,1,8,6,-1,3,1.6,0,2.666666667,1.4,3,0.333333333,36.25,27.5,36.25,30,16.7,0.625,Sweden-Div-1-North,2022/05/06,2022/05/07 12:00
10,Motala,5,2,0,3,7,8,2,2,0,0,6,0,3,0,0,3,1,8,6,-1,3,1.6,0,2.666666667,1.4,3,0.333333333,36.25,27.5,36.25,30,16.7,0.625,Sweden-Div-1-North,2022/05/06,2022/04/30 15:00
11,Vasa Essinge,5,1,3,1,5,8,3,1,2,0,4,3,2,0,1,1,1,5,6,-3,2.6,1.6,1,2.5,1,1.333333333,0.5,36.25,27.5,36.25,30,16.7,0.6875,Sweden-Div-1-North,2022/05/06,2022/05/08 15:00
12,Sollent Utd,5,0,4,1,5,7,3,0,3,0,4,4,2,0,1,1,1,3,4,-2,2.4,1.4,1.333333333,1.5,1,1.333333333,0.5,36.25,27.5,36.25,30,16.7,0.75,Sweden-Div-1-North,2022/05/06,2022/04/30 13:00
12,Sollent Utd,5,0,4,1,5,7,3,0,3,0,4,4,2,0,1,1,1,3,4,-2,2.4,1.4,1.333333333,1.5,1,1.333333333,0.5,36.25,27.5,36.25,30,16.7,0.75,Sweden-Div-1-North,2022/05/06,2022/05/06 18:00
13,Hamm Talang,5,1,1,3,4,7,3,1,0,2,4,6,2,0,1,1,0,1,4,-3,2.2,1.4,2,0.5,0.8,1.333333333,0,36.25,27.5,36.25,30,16.7,0.8125,Sweden-Div-1-North,2022/05/06,2022/04/30 12:00
13,Hamm Talang,5,1,1,3,4,7,3,1,0,2,4,6,2,0,1,1,0,1,4,-3,2.2,1.4,2,0.5,0.8,1.333333333,0,36.25,27.5,36.25,30,16.7,0.8125,Sweden-Div-1-North,2022/05/06,2022/05/08 16:00
14,Pitea,5,1,1,3,8,11,2,1,0,1,4,4,3,0,1,2,4,7,4,-3,3.8,2.2,2,2.333333333,1.6,2,1.333333333,36.25,27.5,36.25,30,16.7,0.875,Sweden-Div-1-North,2022/05/06,2022/05/01 13:00
14,Pitea,5,1,1,3,8,11,2,1,0,1,4,4,3,0,1,2,4,7,4,-3,3.8,2.2,2,2.333333333,1.6,2,1.333333333,36.25,27.5,36.25,30,16.7,0.875,Sweden-Div-1-North,2022/05/06,2022/05/08 12:00
15,Forward,5,1,1,3,5,12,2,0,1,1,2,4,3,1,0,2,3,8,4,-7,3.4,2.4,2,2.666666667,1,1,1,36.25,27.5,36.25,30,16.7,0.9375,Sweden-Div-1-North,2022/05/06,2022/05/08 15:00
15,Forward,5,1,1,3,5,12,2,0,1,1,2,4,3,1,0,2,3,8,4,-7,3.4,2.4,2,2.666666667,1,1,1,36.25,27.5,36.25,30,16.7,0.9375,Sweden-Div-1-North,2022/05/06,2022/04/30 12:00
16,Team Thoren,5,0,0,5,1,19,2,0,0,2,1,9,3,0,0,3,0,10,0,-18,4,3.8,4.5,3.333333333,0.2,0.5,0,36.25,27.5,36.25,30,16.7,1,Sweden-Div-1-North,2022/05/06,2022/04/30 12:00
16,Team Thoren,5,0,0,5,1,19,2,0,0,2,1,9,3,0,0,3,0,10,0,-18,4,3.8,4.5,3.333333333,0.2,0.5,0,36.25,27.5,36.25,30,16.7,1,Sweden-Div-1-North,2022/05/06,2022/05/07 12:00
1,Oddevold,5,4,0,1,17,4,2,2,0,0,7,0,3,2,0,1,10,4,12,13,4.2,0.8,0,1.333333333,3.4,3.5,3.333333333,37.5,25,37.5,30,16.7,0.0625,Sweden-Div-1-South,2022/05/06,2022/05/06 18:30
2,GAIS,5,4,0,1,6,4,3,3,0,0,4,1,2,1,0,1,2,3,12,2,2,0.8,0.333333333,1.5,1.2,1.333333333,1,37.5,25,37.5,30,16.7,0.125,Sweden-Div-1-South,2022/05/06,2022/05/07 15:00
2,GAIS,5,4,0,1,6,4,3,3,0,0,4,1,2,1,0,1,2,3,12,2,2,0.8,0.333333333,1.5,1.2,1.333333333,1,37.5,25,37.5,30,16.7,0.125,Sweden-Div-1-South,2022/05/06,2022/04/30 13:00
3,BK Olympic,5,3,2,0,10,7,3,1,2,0,5,4,2,2,0,0,5,3,11,3,3.4,1.4,1.333333333,1.5,2,1.666666667,2.5,37.5,25,37.5,30,16.7,0.1875,Sweden-Div-1-South,2022/05/06,2022/04/30 13:00
3,BK Olympic,5,3,2,0,10,7,3,1,2,0,5,4,2,2,0,0,5,3,11,3,3.4,1.4,1.333333333,1.5,2,1.666666667,2.5,37.5,25,37.5,30,16.7,0.1875,Sweden-Div-1-South,2022/05/06,2022/05/06 18:00
4,Ljungskile,5,3,1,1,15,7,2,1,1,0,5,2,3,2,0,1,10,5,10,8,4.4,1.4,1,1.666666667,3,2.5,3.333333333,37.5,25,37.5,30,16.7,0.25,Sweden-Div-1-South,2022/05/06,2022/04/30 15:00
4,Ljungskile,5,3,1,1,15,7,2,1,1,0,5,2,3,2,0,1,10,5,10,8,4.4,1.4,1,1.666666667,3,2.5,3.333333333,37.5,25,37.5,30,16.7,0.25,Sweden-Div-1-South,2022/05/06,2022/05/07 15:00
5,Tvaaker,5,3,1,1,10,4,2,2,0,0,7,1,3,1,1,1,3,3,10,6,2.8,0.8,0.5,1,2,3.5,1,37.5,25,37.5,30,16.7,0.3125,Sweden-Div-1-South,2022/05/06,2022/05/07 15:00
5,Tvaaker,5,3,1,1,10,4,2,2,0,0,7,1,3,1,1,1,3,3,10,6,2.8,0.8,0.5,1,2,3.5,1,37.5,25,37.5,30,16.7,0.3125,Sweden-Div-1-South,2022/05/06,2022/04/30 15:00
6,Angelholm,5,3,1,1,8,6,3,2,1,0,6,3,2,1,0,1,2,3,10,2,2.8,1.2,1,1.5,1.6,2,1,37.5,25,37.5,30,16.7,0.375,Sweden-Div-1-South,2022/05/06,2022/04/30 13:00
6,Angelholm,5,3,1,1,8,6,3,2,1,0,6,3,2,1,0,1,2,3,10,2,2.8,1.2,1,1.5,1.6,2,1,37.5,25,37.5,30,16.7,0.375,Sweden-Div-1-South,2022/05/06,2022/05/06 18:00
7,Oskarshamns,5,2,2,1,8,6,2,1,1,0,5,4,3,1,1,1,3,2,8,2,2.8,1.2,2,0.666666667,1.6,2.5,1,37.5,25,37.5,30,16.7,0.4375,Sweden-Div-1-South,2022/05/06,2022/04/30 15:00
7,Oskarshamns,5,2,2,1,8,6,2,1,1,0,5,4,3,1,1,1,3,2,8,2,2.8,1.2,2,0.666666667,1.6,2.5,1,37.5,25,37.5,30,16.7,0.4375,Sweden-Div-1-South,2022/05/06,2022/05/07 15:00
8,Vanersborg,5,2,2,1,7,7,3,2,0,1,4,4,2,0,2,0,3,3,8,0,2.8,1.4,1.333333333,1.5,1.4,1.333333333,1.5,37.5,25,37.5,30,16.7,0.5,Sweden-Div-1-South,2022/05/06,2022/05/06 18:30
8,Vanersborg,5,2,2,1,7,7,3,2,0,1,4,4,2,0,2,0,3,3,8,0,2.8,1.4,1.333333333,1.5,1.4,1.333333333,1.5,37.5,25,37.5,30,16.7,0.5,Sweden-Div-1-South,2022/05/06,2022/04/30 13:00
9,FC Trollhattan,5,1,3,1,2,2,3,1,1,1,1,1,2,0,2,0,1,1,6,0,0.8,0.4,0.333333333,0.5,0.4,0.333333333,0.5,37.5,25,37.5,30,16.7,0.5625,Sweden-Div-1-South,2022/05/06,2022/05/02 18:00
9,FC Trollhattan,5,1,3,1,2,2,3,1,1,1,1,1,2,0,2,0,1,1,6,0,0.8,0.4,0.333333333,0.5,0.4,0.333333333,0.5,37.5,25,37.5,30,16.7,0.5625,Sweden-Div-1-South,2022/05/06,2022/05/09 18:30
10,Falkenberg,5,2,0,3,4,7,2,2,0,0,3,1,3,0,0,3,1,6,6,-3,2.2,1.4,0.5,2,0.8,1.5,0.333333333,37.5,25,37.5,30,16.7,0.625,Sweden-Div-1-South,2022/05/06,2022/05/02 18:00
10,Falkenberg,5,2,0,3,4,7,2,2,0,0,3,1,3,0,0,3,1,6,6,-3,2.2,1.4,0.5,2,0.8,1.5,0.333333333,37.5,25,37.5,30,16.7,0.625,Sweden-Div-1-South,2022/05/06,2022/05/07 12:00
11,Lunds,5,1,3,1,6,9,2,1,1,0,2,1,3,0,2,1,4,8,6,-3,3,1.8,0.5,2.666666667,1.2,1,1.333333333,37.5,25,37.5,30,16.7,0.6875,Sweden-Div-1-South,2022/05/06,2022/05/06 18:00
11,Lunds,5,1,3,1,6,9,2,1,1,0,2,1,3,0,2,1,4,8,6,-3,3,1.8,0.5,2.666666667,1.2,1,1.333333333,37.5,25,37.5,30,16.7,0.6875,Sweden-Div-1-South,2022/05/06,2022/04/30 15:00
12,Torns,5,1,1,3,6,10,3,1,1,1,6,8,2,0,0,2,0,2,4,-4,3.2,2,2.666666667,1,1.2,2,0,37.5,25,37.5,30,16.7,0.75,Sweden-Div-1-South,2022/05/06,2022/04/30 12:00
12,Torns,5,1,1,3,6,10,3,1,1,1,6,8,2,0,0,2,0,2,4,-4,3.2,2,2.666666667,1,1.2,2,0,37.5,25,37.5,30,16.7,0.75,Sweden-Div-1-South,2022/05/06,2022/05/07 15:00
13,Qviding,5,1,1,3,5,10,2,1,0,1,3,2,3,0,1,2,2,8,4,-5,3,2,1,2.666666667,1,1.5,0.666666667,37.5,25,37.5,30,16.7,0.8125,Sweden-Div-1-South,2022/05/06,2022/05/09 18:30
14,Atvidaberg,5,0,2,3,4,7,3,0,1,2,3,5,2,0,1,1,1,2,2,-3,2.2,1.4,1.666666667,1,0.8,1,0.5,37.5,25,37.5,30,16.7,0.875,Sweden-Div-1-South,2022/05/06,2022/04/30 15:00
14,Atvidaberg,5,0,2,3,4,7,3,0,1,2,3,5,2,0,1,1,1,2,2,-3,2.2,1.4,1.666666667,1,0.8,1,0.5,37.5,25,37.5,30,16.7,0.875,Sweden-Div-1-South,2022/05/06,2022/05/07 15:00
15,IFK Malmo,5,0,1,4,4,14,3,0,1,2,3,9,2,0,0,2,1,5,1,-10,3.6,2.8,3,2.5,0.8,1,0.5,37.5,25,37.5,30,16.7,0.9375,Sweden-Div-1-South,2022/05/06,2022/05/06 18:00
15,IFK Malmo,5,0,1,4,4,14,3,0,1,2,3,9,2,0,0,2,1,5,1,-10,3.6,2.8,3,2.5,0.8,1,0.5,37.5,25,37.5,30,16.7,0.9375,Sweden-Div-1-South,2022/05/06,2022/04/30 15:00
16,Lindome GIF,5,0,0,5,11,19,2,0,0,2,5,8,3,0,0,3,6,11,0,-8,6,3.8,4,3.666666667,2.2,2.5,2,37.5,25,37.5,30,16.7,1,Sweden-Div-1-South,2022/05/06,2022/05/07 12:00
16,Lindome GIF,5,0,0,5,11,19,2,0,0,2,5,8,3,0,0,3,6,11,0,-8,6,3.8,4,3.666666667,2.2,2.5,2,37.5,25,37.5,30,16.7,1,Sweden-Div-1-South,2022/05/06,2022/04/30 12:00
1,Winterthur,32,16,9,7,65,41,16,11,3,2,39,17,16,5,6,5,26,24,57,24,3.31,1.28125,1.0625,1.5,2.03125,2.4375,1.625,39.6875,20.625,39.6875,18,177.8,0.1,Switzerland-Challenge,2022/05/06,2022/04/29 19:15
1,Winterthur,32,16,9,7,65,41,16,11,3,2,39,17,16,5,6,5,26,24,57,24,3.31,1.28125,1.0625,1.5,2.03125,2.4375,1.625,39.6875,20.625,39.6875,18,177.8,0.1,Switzerland-Challenge,2022/05/06,2022/05/06 18:30
1,Winterthur,32,16,9,7,65,41,16,11,3,2,39,17,16,5,6,5,26,24,57,24,3.31,1.28125,1.0625,1.5,2.03125,2.4375,1.625,39.6875,20.625,39.6875,18,177.8,0.1,Switzerland-Challenge,2022/05/06,2022/05/09 19:15
2,Schaffhausen,32,16,8,8,62,44,16,11,4,1,37,19,16,5,4,7,25,25,56,18,3.31,1.375,1.1875,1.5625,1.9375,2.3125,1.5625,39.6875,20.625,39.6875,18,177.8,0.2,Switzerland-Challenge,2022/05/06,2022/05/06 18:30
2,Schaffhausen,32,16,8,8,62,44,16,11,4,1,37,19,16,5,4,7,25,25,56,18,3.31,1.375,1.1875,1.5625,1.9375,2.3125,1.5625,39.6875,20.625,39.6875,18,177.8,0.2,Switzerland-Challenge,2022/05/06,2022/04/29 19:15
2,Schaffhausen,32,16,8,8,62,44,16,11,4,1,37,19,16,5,4,7,25,25,56,18,3.31,1.375,1.1875,1.5625,1.9375,2.3125,1.5625,39.6875,20.625,39.6875,18,177.8,0.2,Switzerland-Challenge,2022/05/06,2022/05/10 18:30
3,Aarau,32,17,5,10,59,44,16,9,2,5,25,20,16,8,3,5,34,24,56,15,3.22,1.375,1.25,1.5,1.84375,1.5625,2.125,39.6875,20.625,39.6875,18,177.8,0.3,Switzerland-Challenge,2022/05/06,2022/05/09 19:15
3,Aarau,32,17,5,10,59,44,16,9,2,5,25,20,16,8,3,5,34,24,56,15,3.22,1.375,1.25,1.5,1.84375,1.5625,2.125,39.6875,20.625,39.6875,18,177.8,0.3,Switzerland-Challenge,2022/05/06,2022/04/29 18:30
3,Aarau,32,17,5,10,59,44,16,9,2,5,25,20,16,8,3,5,34,24,56,15,3.22,1.375,1.25,1.5,1.84375,1.5625,2.125,39.6875,20.625,39.6875,18,177.8,0.3,Switzerland-Challenge,2022/05/06,2022/05/06 19:15
4,Vaduz,32,15,5,12,58,53,16,8,2,6,26,22,16,7,3,6,32,31,50,5,3.47,1.65625,1.375,1.9375,1.8125,1.625,2,39.6875,20.625,39.6875,18,177.8,0.4,Switzerland-Challenge,2022/05/06,2022/05/06 19:15
4,Vaduz,32,15,5,12,58,53,16,8,2,6,26,22,16,7,3,6,32,31,50,5,3.47,1.65625,1.375,1.9375,1.8125,1.625,2,39.6875,20.625,39.6875,18,177.8,0.4,Switzerland-Challenge,2022/05/06,2022/04/30 17:00
4,Vaduz,32,15,5,12,58,53,16,8,2,6,26,22,16,7,3,6,32,31,50,5,3.47,1.65625,1.375,1.9375,1.8125,1.625,2,39.6875,20.625,39.6875,18,177.8,0.4,Switzerland-Challenge,2022/05/06,2022/05/10 18:30
5,Thun,32,15,4,13,54,48,16,9,2,5,32,23,16,6,2,8,22,25,49,6,3.19,1.5,1.4375,1.5625,1.6875,2,1.375,39.6875,20.625,39.6875,18,177.8,0.5,Switzerland-Challenge,2022/05/06,2022/04/30 17:00
5,Thun,32,15,4,13,54,48,16,9,2,5,32,23,16,6,2,8,22,25,49,6,3.19,1.5,1.4375,1.5625,1.6875,2,1.375,39.6875,20.625,39.6875,18,177.8,0.5,Switzerland-Challenge,2022/05/06,2022/05/10 18:30
5,Thun,32,15,4,13,54,48,16,9,2,5,32,23,16,6,2,8,22,25,49,6,3.19,1.5,1.4375,1.5625,1.6875,2,1.375,39.6875,20.625,39.6875,18,177.8,0.5,Switzerland-Challenge,2022/05/06,2022/05/06 18:30
6,Std Lausanne,32,12,7,13,41,41,16,9,4,3,26,15,16,3,3,10,15,26,43,0,2.56,1.28125,0.9375,1.625,1.28125,1.625,0.9375,39.6875,20.625,39.6875,18,177.8,0.6,Switzerland-Challenge,2022/05/06,2022/05/06 18:30
6,Std Lausanne,32,12,7,13,41,41,16,9,4,3,26,15,16,3,3,10,15,26,43,0,2.56,1.28125,0.9375,1.625,1.28125,1.625,0.9375,39.6875,20.625,39.6875,18,177.8,0.6,Switzerland-Challenge,2022/05/06,2022/04/30 17:00
6,Std Lausanne,32,12,7,13,41,41,16,9,4,3,26,15,16,3,3,10,15,26,43,0,2.56,1.28125,0.9375,1.625,1.28125,1.625,0.9375,39.6875,20.625,39.6875,18,177.8,0.6,Switzerland-Challenge,2022/05/06,2022/05/09 19:15
7,Xamax,32,12,7,13,46,47,16,8,3,5,29,25,16,4,4,8,17,22,43,-1,2.91,1.46875,1.5625,1.375,1.4375,1.8125,1.0625,39.6875,20.625,39.6875,18,177.8,0.7,Switzerland-Challenge,2022/05/06,2022/04/29 18:30
7,Xamax,32,12,7,13,46,47,16,8,3,5,29,25,16,4,4,8,17,22,43,-1,2.91,1.46875,1.5625,1.375,1.4375,1.8125,1.0625,39.6875,20.625,39.6875,18,177.8,0.7,Switzerland-Challenge,2022/05/06,2022/05/10 18:30
7,Xamax,32,12,7,13,46,47,16,8,3,5,29,25,16,4,4,8,17,22,43,-1,2.91,1.46875,1.5625,1.375,1.4375,1.8125,1.0625,39.6875,20.625,39.6875,18,177.8,0.7,Switzerland-Challenge,2022/05/06,2022/05/06 18:30
8,Yverdon,32,10,10,12,39,43,16,6,7,3,22,18,16,4,3,9,17,25,40,-4,2.56,1.34375,1.125,1.5625,1.21875,1.375,1.0625,39.6875,20.625,39.6875,18,177.8,0.8,Switzerland-Challenge,2022/05/06,2022/05/06 19:15
8,Yverdon,32,10,10,12,39,43,16,6,7,3,22,18,16,4,3,9,17,25,40,-4,2.56,1.34375,1.125,1.5625,1.21875,1.375,1.0625,39.6875,20.625,39.6875,18,177.8,0.8,Switzerland-Challenge,2022/05/06,2022/04/30 17:00
8,Yverdon,32,10,10,12,39,43,16,6,7,3,22,18,16,4,3,9,17,25,40,-4,2.56,1.34375,1.125,1.5625,1.21875,1.375,1.0625,39.6875,20.625,39.6875,18,177.8,0.8,Switzerland-Challenge,2022/05/06,2022/05/10 18:30
9,Wil,32,11,7,14,62,67,16,8,4,4,42,29,16,3,3,10,20,38,40,-5,4.03,2.09375,1.8125,2.375,1.9375,2.625,1.25,39.6875,20.625,39.6875,18,177.8,0.9,Switzerland-Challenge,2022/05/06,2022/04/30 17:00
9,Wil,32,11,7,14,62,67,16,8,4,4,42,29,16,3,3,10,20,38,40,-5,4.03,2.09375,1.8125,2.375,1.9375,2.625,1.25,39.6875,20.625,39.6875,18,177.8,0.9,Switzerland-Challenge,2022/05/06,2022/05/09 19:15
9,Wil,32,11,7,14,62,67,16,8,4,4,42,29,16,3,3,10,20,38,40,-5,4.03,2.09375,1.8125,2.375,1.9375,2.625,1.25,39.6875,20.625,39.6875,18,177.8,0.9,Switzerland-Challenge,2022/05/06,2022/05/06 19:15
10,Kriens,32,3,4,25,22,80,16,3,2,11,10,32,16,0,2,14,12,48,13,-58,3.19,2.5,2,3,0.6875,0.625,0.75,39.6875,20.625,39.6875,18,177.8,1,Switzerland-Challenge,2022/05/06,2022/04/30 17:00
10,Kriens,32,3,4,25,22,80,16,3,2,11,10,32,16,0,2,14,12,48,13,-58,3.19,2.5,2,3,0.6875,0.625,0.75,39.6875,20.625,39.6875,18,177.8,1,Switzerland-Challenge,2022/05/06,2022/05/10 18:30
10,Kriens,32,3,4,25,22,80,16,3,2,11,10,32,16,0,2,14,12,48,13,-58,3.19,2.5,2,3,0.6875,0.625,0.75,39.6875,20.625,39.6875,18,177.8,1,Switzerland-Challenge,2022/05/06,2022/05/06 18:30
1,Trabzonspor,35,22,11,2,65,31,18,11,7,0,33,16,17,11,4,2,32,15,77,34,2.74,0.885714286,0.888888889,0.882352941,1.857142857,1.833333333,1.882352941,38.28571429,23.42857143,38.28571429,38,92.1,0.05,Turkey-Super-Lig,2022/05/06,2022/05/06 18:00
2,Fenerbahce,35,20,8,7,67,37,18,11,4,3,33,17,17,9,4,4,34,20,68,30,2.97,1.057142857,0.944444444,1.176470588,1.914285714,1.833333333,2,38.28571429,23.42857143,38.28571429,38,92.1,0.1,Turkey-Super-Lig,2022/05/06,2022/05/08 17:00
3,Konyaspor,35,19,7,9,60,40,18,12,4,2,33,14,17,7,3,7,27,26,64,20,2.86,1.142857143,0.777777778,1.529411765,1.714285714,1.833333333,1.588235294,38.28571429,23.42857143,38.28571429,38,92.1,0.15,Turkey-Super-Lig,2022/05/06,2022/05/09 18:00
4,Istanbul BB,35,18,6,11,52,34,17,11,1,5,27,14,18,7,5,6,25,20,60,18,2.46,0.971428571,0.823529412,1.111111111,1.485714286,1.588235294,1.388888889,38.28571429,23.42857143,38.28571429,38,92.1,0.2,Turkey-Super-Lig,2022/05/06,2022/05/07 17:00
5,Alanyaspor,35,16,7,12,61,57,18,8,4,6,36,31,17,8,3,6,25,26,55,4,3.37,1.628571429,1.722222222,1.529411765,1.742857143,2,1.470588235,38.28571429,23.42857143,38.28571429,38,92.1,0.25,Turkey-Super-Lig,2022/05/06,2022/05/01 14:00
5,Alanyaspor,35,16,7,12,61,57,18,8,4,6,36,31,17,8,3,6,25,26,55,4,3.37,1.628571429,1.722222222,1.529411765,1.742857143,2,1.470588235,38.28571429,23.42857143,38.28571429,38,92.1,0.25,Turkey-Super-Lig,2022/05/06,2022/05/07 17:00
6,Besiktas,35,14,12,9,52,46,17,10,4,3,30,21,18,4,8,6,22,25,54,6,2.8,1.314285714,1.235294118,1.388888889,1.485714286,1.764705882,1.222222222,38.28571429,23.42857143,38.28571429,38,92.1,0.3,Turkey-Super-Lig,2022/05/06,2022/05/08 17:00
6,Besiktas,35,14,12,9,52,46,17,10,4,3,30,21,18,4,8,6,22,25,54,6,2.8,1.314285714,1.235294118,1.388888889,1.485714286,1.764705882,1.222222222,38.28571429,23.42857143,38.28571429,38,92.1,0.3,Turkey-Super-Lig,2022/05/06,2022/05/01 14:00
7,Karagumruk,35,15,8,12,44,50,17,9,5,3,26,16,18,6,3,9,18,34,53,-6,2.69,1.428571429,0.941176471,1.888888889,1.257142857,1.529411765,1,38.28571429,23.42857143,38.28571429,38,92.1,0.35,Turkey-Super-Lig,2022/05/06,2022/05/07 14:00
8,Ad.Demirspor,35,14,10,11,50,42,17,8,5,4,27,15,18,6,5,7,23,27,52,8,2.63,1.2,0.882352941,1.5,1.428571429,1.588235294,1.277777778,38.28571429,23.42857143,38.28571429,38,92.1,0.4,Turkey-Super-Lig,2022/05/06,2022/05/07 17:00
9,Antalyaspor,35,14,10,11,46,42,17,9,5,3,30,16,18,5,5,8,16,26,52,4,2.51,1.2,0.941176471,1.444444444,1.314285714,1.764705882,0.888888889,38.28571429,23.42857143,38.28571429,38,92.1,0.45,Turkey-Super-Lig,2022/05/06,2022/05/09 18:00
10,Hatayspor,35,14,7,14,50,55,17,9,4,4,31,19,18,5,3,10,19,36,49,-5,3,1.571428571,1.117647059,2,1.428571429,1.823529412,1.055555556,38.28571429,23.42857143,38.28571429,38,92.1,0.5,Turkey-Super-Lig,2022/05/06,2022/04/30 18:30
10,Hatayspor,35,14,7,14,50,55,17,9,4,4,31,19,18,5,3,10,19,36,49,-5,3,1.571428571,1.117647059,2,1.428571429,1.823529412,1.055555556,38.28571429,23.42857143,38.28571429,38,92.1,0.5,Turkey-Super-Lig,2022/05/06,2022/05/06 18:00
11,Sivasspor,35,12,12,11,47,45,17,6,8,3,25,17,18,6,4,8,22,28,48,2,2.63,1.285714286,1,1.555555556,1.342857143,1.470588235,1.222222222,38.28571429,23.42857143,38.28571429,38,92.1,0.55,Turkey-Super-Lig,2022/05/06,2022/05/07 14:00
11,Sivasspor,35,12,12,11,47,45,17,6,8,3,25,17,18,6,4,8,22,28,48,2,2.63,1.285714286,1,1.555555556,1.342857143,1.470588235,1.222222222,38.28571429,23.42857143,38.28571429,38,92.1,0.55,Turkey-Super-Lig,2022/05/06,2022/05/01 18:30
12,Kasimpasa,35,13,8,14,58,50,18,8,4,6,34,25,17,5,4,8,24,25,47,8,3.09,1.428571429,1.388888889,1.470588235,1.657142857,1.888888889,1.411764706,38.28571429,23.42857143,38.28571429,38,92.1,0.6,Turkey-Super-Lig,2022/05/06,2022/05/07 14:00
13,Galatasaray,35,13,8,14,47,50,18,9,3,6,28,21,17,4,5,8,19,29,47,-3,2.77,1.428571429,1.166666667,1.705882353,1.342857143,1.555555556,1.117647059,38.28571429,23.42857143,38.28571429,38,92.1,0.65,Turkey-Super-Lig,2022/05/06,2022/05/01 18:30
13,Galatasaray,35,13,8,14,47,50,18,9,3,6,28,21,17,4,5,8,19,29,47,-3,2.77,1.428571429,1.166666667,1.705882353,1.342857143,1.555555556,1.117647059,38.28571429,23.42857143,38.28571429,38,92.1,0.65,Turkey-Super-Lig,2022/05/06,2022/05/07 17:00
14,Giresunspor,35,12,7,16,38,41,18,7,4,7,22,20,17,5,3,9,16,21,43,-3,2.26,1.171428571,1.111111111,1.235294118,1.085714286,1.222222222,0.941176471,38.28571429,23.42857143,38.28571429,38,92.1,0.7,Turkey-Super-Lig,2022/05/06,2022/05/08 14:00
15,Kayserispor,35,11,10,14,49,58,18,9,4,5,29,22,17,2,6,9,20,36,43,-9,3.06,1.657142857,1.222222222,2.117647059,1.4,1.611111111,1.176470588,38.28571429,23.42857143,38.28571429,38,92.1,0.75,Turkey-Super-Lig,2022/05/06,2022/05/01 14:00
15,Kayserispor,35,11,10,14,49,58,18,9,4,5,29,22,17,2,6,9,20,36,43,-9,3.06,1.657142857,1.222222222,2.117647059,1.4,1.611111111,1.176470588,38.28571429,23.42857143,38.28571429,38,92.1,0.75,Turkey-Super-Lig,2022/05/06,2022/05/06 18:00
16,Gazis Gazian,35,11,9,15,45,52,17,10,6,1,32,16,18,1,3,14,13,36,42,-7,2.77,1.485714286,0.941176471,2,1.285714286,1.882352941,0.722222222,38.28571429,23.42857143,38.28571429,38,92.1,0.8,Turkey-Super-Lig,2022/05/06,2022/05/06 18:00
17,Altay,35,9,6,20,35,50,17,5,3,9,17,22,18,4,3,11,18,28,33,-15,2.43,1.428571429,1.294117647,1.555555556,1,1,1,38.28571429,23.42857143,38.28571429,38,92.1,0.85,Turkey-Super-Lig,2022/05/06,2022/05/08 14:00
17,Altay,35,9,6,20,35,50,17,5,3,9,17,22,18,4,3,11,18,28,33,-15,2.43,1.428571429,1.294117647,1.555555556,1,1,1,38.28571429,23.42857143,38.28571429,38,92.1,0.85,Turkey-Super-Lig,2022/05/06,2022/04/30 18:30
18,Rizespor,35,9,6,20,40,66,18,8,2,8,23,29,17,1,4,12,17,37,33,-26,3.03,1.885714286,1.611111111,2.176470588,1.142857143,1.277777778,1,38.28571429,23.42857143,38.28571429,38,92.1,0.9,Turkey-Super-Lig,2022/05/06,2022/05/01 18:30
18,Rizespor,35,9,6,20,40,66,18,8,2,8,23,29,17,1,4,12,17,37,33,-26,3.03,1.885714286,1.611111111,2.176470588,1.142857143,1.277777778,1,38.28571429,23.42857143,38.28571429,38,92.1,0.9,Turkey-Super-Lig,2022/05/06,2022/05/08 14:00
19,Goztepe,35,7,7,21,39,65,18,4,2,12,18,32,17,3,5,9,21,33,28,-26,2.97,1.857142857,1.777777778,1.941176471,1.114285714,1,1.235294118,38.28571429,23.42857143,38.28571429,38,92.1,0.95,Turkey-Super-Lig,2022/05/06,2022/05/01 18:30
19,Goztepe,35,7,7,21,39,65,18,4,2,12,18,32,17,3,5,9,21,33,28,-26,2.97,1.857142857,1.777777778,1.941176471,1.114285714,1,1.235294118,38.28571429,23.42857143,38.28571429,38,92.1,0.95,Turkey-Super-Lig,2022/05/06,2022/05/07 14:00
20,Malatyaspor,35,5,5,25,26,60,17,3,3,11,19,35,18,2,2,14,7,25,20,-34,2.46,1.714285714,2.058823529,1.388888889,0.742857143,1.117647059,0.388888889,38.28571429,23.42857143,38.28571429,38,92.1,1,Turkey-Super-Lig,2022/05/06,2022/05/08 14:00
20,Malatyaspor,35,5,5,25,26,60,17,3,3,11,19,35,18,2,2,14,7,25,20,-34,2.46,1.714285714,2.058823529,1.388888889,0.742857143,1.117647059,0.388888889,38.28571429,23.42857143,38.28571429,38,92.1,1,Turkey-Super-Lig,2022/05/06,2022/05/01 14:00
1,Al Ain,21,16,4,1,45,16,11,9,2,0,24,8,10,7,2,1,21,8,52,29,2.9,0.761904762,0.727272727,0.8,2.142857143,2.181818182,2.1,37,26,37,26,80.8,0.071428571,UAE-Arabian-Gulf-League,2022/05/06,2022/04/30 19:00
1,Al Ain,21,16,4,1,45,16,11,9,2,0,24,8,10,7,2,1,21,8,52,29,2.9,0.761904762,0.727272727,0.8,2.142857143,2.181818182,2.1,37,26,37,26,80.8,0.071428571,UAE-Arabian-Gulf-League,2022/05/06,2022/05/07 15:00
2,Al Wahda U,21,13,6,2,42,18,10,6,3,1,19,9,11,7,3,1,23,9,45,24,2.86,0.857142857,0.9,0.818181818,2,1.9,2.090909091,37,26,37,26,80.8,0.142857143,UAE-Arabian-Gulf-League,2022/05/06,2022/05/06 17:45
2,Al Wahda U,21,13,6,2,42,18,10,6,3,1,19,9,11,7,3,1,23,9,45,24,2.86,0.857142857,0.9,0.818181818,2,1.9,2.090909091,37,26,37,26,80.8,0.142857143,UAE-Arabian-Gulf-League,2022/05/06,2022/05/10 15:00
3,Al Sharjah,21,13,3,5,34,21,11,9,0,2,20,10,10,4,3,3,14,11,42,13,2.62,1,0.909090909,1.1,1.619047619,1.818181818,1.4,37,26,37,26,80.8,0.214285714,UAE-Arabian-Gulf-League,2022/05/06,2022/04/30 19:00
3,Al Sharjah,21,13,3,5,34,21,11,9,0,2,20,10,10,4,3,3,14,11,42,13,2.62,1,0.909090909,1.1,1.619047619,1.818181818,1.4,37,26,37,26,80.8,0.214285714,UAE-Arabian-Gulf-League,2022/05/06,2022/05/10 17:45
3,Al Sharjah,21,13,3,5,34,21,11,9,0,2,20,10,10,4,3,3,14,11,42,13,2.62,1,0.909090909,1.1,1.619047619,1.818181818,1.4,37,26,37,26,80.8,0.214285714,UAE-Arabian-Gulf-League,2022/05/06,2022/05/06 17:45
4,Al Jazira,21,13,3,5,36,23,11,10,0,1,24,13,10,3,3,4,12,10,42,13,2.81,1.095238095,1.181818182,1,1.714285714,2.181818182,1.2,37,26,37,26,80.8,0.285714286,UAE-Arabian-Gulf-League,2022/05/06,2022/05/06 15:00
4,Al Jazira,21,13,3,5,36,23,11,10,0,1,24,13,10,3,3,4,12,10,42,13,2.81,1.095238095,1.181818182,1,1.714285714,2.181818182,1.2,37,26,37,26,80.8,0.285714286,UAE-Arabian-Gulf-League,2022/05/06,2022/04/30 19:00
5,Bani Yas,22,8,6,8,30,29,11,5,2,4,16,11,11,3,4,4,14,18,30,1,2.68,1.318181818,1,1.636363636,1.363636364,1.454545455,1.272727273,37,26,37,26,84.6,0.357142857,UAE-Arabian-Gulf-League,2022/05/06,2022/04/30 19:00
5,Bani Yas,22,8,6,8,30,29,11,5,2,4,16,11,11,3,4,4,14,18,30,1,2.68,1.318181818,1,1.636363636,1.363636364,1.454545455,1.272727273,37,26,37,26,84.6,0.357142857,UAE-Arabian-Gulf-League,2022/05/06,2022/05/05 15:00
5,Bani Yas,22,8,6,8,30,29,11,5,2,4,16,11,11,3,4,4,14,18,30,1,2.68,1.318181818,1,1.636363636,1.363636364,1.454545455,1.272727273,37,26,37,26,84.6,0.357142857,UAE-Arabian-Gulf-League,2022/05/06,2022/05/10 15:00
6,Al Ahli UAE,21,8,6,7,24,25,10,7,1,2,18,13,11,1,5,5,6,12,30,-1,2.33,1.19047619,1.3,1.090909091,1.142857143,1.8,0.545454545,37,26,37,26,80.8,0.428571429,UAE-Arabian-Gulf-League,2022/05/06,2022/05/07 17:45
6,Al Ahli UAE,21,8,6,7,24,25,10,7,1,2,18,13,11,1,5,5,6,12,30,-1,2.33,1.19047619,1.3,1.090909091,1.142857143,1.8,0.545454545,37,26,37,26,80.8,0.428571429,UAE-Arabian-Gulf-League,2022/05/06,2022/04/30 19:00
7,Al Wasl,22,7,8,7,30,24,10,3,5,2,13,7,12,4,3,5,17,17,29,6,2.45,1.090909091,0.7,1.416666667,1.363636364,1.3,1.416666667,37,26,37,26,84.6,0.5,UAE-Arabian-Gulf-League,2022/05/06,2022/04/23 19:00
7,Al Wasl,22,7,8,7,30,24,10,3,5,2,13,7,12,4,3,5,17,17,29,6,2.45,1.090909091,0.7,1.416666667,1.363636364,1.3,1.416666667,37,26,37,26,84.6,0.5,UAE-Arabian-Gulf-League,2022/05/06,2022/05/05 17:45
8,Al Nasr UAE,22,8,5,9,37,32,11,5,2,4,21,13,11,3,3,5,16,19,29,5,3.14,1.454545455,1.181818182,1.727272727,1.681818182,1.909090909,1.454545455,37,26,37,26,84.6,0.571428571,UAE-Arabian-Gulf-League,2022/05/06,2022/05/05 17:45
9,Ajman,21,8,4,9,26,28,11,5,3,3,17,14,10,3,1,6,9,14,28,-2,2.57,1.333333333,1.272727273,1.4,1.238095238,1.545454545,0.9,37,26,37,26,80.8,0.642857143,UAE-Arabian-Gulf-League,2022/05/06,2022/04/23 19:00
9,Ajman,21,8,4,9,26,28,11,5,3,3,17,14,10,3,1,6,9,14,28,-2,2.57,1.333333333,1.272727273,1.4,1.238095238,1.545454545,0.9,37,26,37,26,80.8,0.642857143,UAE-Arabian-Gulf-League,2022/05/06,2022/05/10 15:00
9,Ajman,21,8,4,9,26,28,11,5,3,3,17,14,10,3,1,6,9,14,28,-2,2.57,1.333333333,1.272727273,1.4,1.238095238,1.545454545,0.9,37,26,37,26,80.8,0.642857143,UAE-Arabian-Gulf-League,2022/05/06,2022/05/06 15:00
10,Al Ittihad Ua,21,5,9,7,25,29,11,2,6,3,11,14,10,3,3,4,14,15,24,-4,2.57,1.380952381,1.272727273,1.5,1.19047619,1,1.4,37,26,37,26,80.8,0.714285714,UAE-Arabian-Gulf-League,2022/05/06,2022/05/07 17:45
11,Khor Fakkan,22,6,4,12,31,41,11,5,2,4,18,12,11,1,2,8,13,29,22,-10,3.27,1.863636364,1.090909091,2.636363636,1.409090909,1.636363636,1.181818182,37,26,37,26,84.6,0.785714286,UAE-Arabian-Gulf-League,2022/05/06,2022/05/05 15:00
11,Khor Fakkan,22,6,4,12,31,41,11,5,2,4,18,12,11,1,2,8,13,29,22,-10,3.27,1.863636364,1.090909091,2.636363636,1.409090909,1.636363636,1.181818182,37,26,37,26,84.6,0.785714286,UAE-Arabian-Gulf-League,2022/05/06,2022/04/23 19:00
11,Khor Fakkan,22,6,4,12,31,41,11,5,2,4,18,12,11,1,2,8,13,29,22,-10,3.27,1.863636364,1.090909091,2.636363636,1.409090909,1.636363636,1.181818182,37,26,37,26,84.6,0.785714286,UAE-Arabian-Gulf-League,2022/05/06,2022/05/10 17:45
12,Al Dhafra,21,3,7,11,22,32,10,2,4,4,13,14,11,1,3,7,9,18,16,-10,2.57,1.523809524,1.4,1.636363636,1.047619048,1.3,0.818181818,37,26,37,26,80.8,0.857142857,UAE-Arabian-Gulf-League,2022/05/06,2022/05/07 15:00
13,Emirates,22,2,5,15,19,50,11,1,4,6,10,23,11,1,1,9,9,27,11,-31,3.14,2.272727273,2.090909091,2.454545455,0.863636364,0.909090909,0.818181818,37,26,37,26,84.6,0.928571429,UAE-Arabian-Gulf-League,2022/05/06,2022/05/05 15:00
13,Emirates,22,2,5,15,19,50,11,1,4,6,10,23,11,1,1,9,9,27,11,-31,3.14,2.272727273,2.090909091,2.454545455,0.863636364,0.909090909,0.818181818,37,26,37,26,84.6,0.928571429,UAE-Arabian-Gulf-League,2022/05/06,2022/04/23 19:00
14,Al Urooba,22,1,8,13,20,53,11,1,5,5,13,23,11,0,3,8,7,30,11,-33,3.32,2.409090909,2.090909091,2.727272727,0.909090909,1.181818182,0.636363636,37,26,37,26,84.6,1,UAE-Arabian-Gulf-League,2022/05/06,2022/05/10 15:00
14,Al Urooba,22,1,8,13,20,53,11,1,5,5,13,23,11,0,3,8,7,30,11,-33,3.32,2.409090909,2.090909091,2.727272727,0.909090909,1.181818182,0.636363636,37,26,37,26,84.6,1,UAE-Arabian-Gulf-League,2022/05/06,2022/04/30 19:00
14,Al Urooba,22,1,8,13,20,53,11,1,5,5,13,23,11,0,3,8,7,30,11,-33,3.32,2.409090909,2.090909091,2.727272727,0.909090909,1.181818182,0.636363636,37,26,37,26,84.6,1,UAE-Arabian-Gulf-League,2022/05/06,2022/05/05 15:00
1,Vipers,27,20,4,3,59,19,14,11,2,1,34,9,13,9,2,2,25,10,64,40,2.89,0.703703704,0.642857143,0.769230769,2.185185185,2.428571429,1.923076923,34.65116279,30.69767442,34.65116279,30,90,0.0625,Uganda-Premier,2022/05/06,2022/05/03 14:00
1,Vipers,27,20,4,3,59,19,14,11,2,1,34,9,13,9,2,2,25,10,64,40,2.89,0.703703704,0.642857143,0.769230769,2.185185185,2.428571429,1.923076923,34.65116279,30.69767442,34.65116279,30,90,0.0625,Uganda-Premier,2022/05/06,2022/05/07 14:00
2,Kampala City,27,14,11,2,39,18,13,9,3,1,19,7,14,5,8,1,20,11,53,21,2.11,0.666666667,0.538461538,0.785714286,1.444444444,1.461538462,1.428571429,34.65116279,30.69767442,34.65116279,30,90,0.125,Uganda-Premier,2022/05/06,2022/05/03 14:00
2,Kampala City,27,14,11,2,39,18,13,9,3,1,19,7,14,5,8,1,20,11,53,21,2.11,0.666666667,0.538461538,0.785714286,1.444444444,1.461538462,1.428571429,34.65116279,30.69767442,34.65116279,30,90,0.125,Uganda-Premier,2022/05/06,2022/05/07 14:00
3,URA SC,27,13,10,4,45,23,13,7,5,1,22,11,14,6,5,3,23,12,49,22,2.52,0.851851852,0.846153846,0.857142857,1.666666667,1.692307692,1.642857143,34.65116279,30.69767442,34.65116279,30,90,0.1875,Uganda-Premier,2022/05/06,2022/05/07 14:00
4,BUL,27,12,10,5,47,28,14,8,4,2,26,8,13,4,6,3,21,20,46,19,2.78,1.037037037,0.571428571,1.538461538,1.740740741,1.857142857,1.615384615,34.65116279,30.69767442,34.65116279,30,90,0.25,Uganda-Premier,2022/05/06,2022/04/30 14:00
4,BUL,27,12,10,5,47,28,14,8,4,2,26,8,13,4,6,3,21,20,46,19,2.78,1.037037037,0.571428571,1.538461538,1.740740741,1.857142857,1.615384615,34.65116279,30.69767442,34.65116279,30,90,0.25,Uganda-Premier,2022/05/06,2022/05/07 12:00
5,Arua Hill,26,11,10,5,31,25,13,8,4,1,23,13,13,3,6,4,8,12,43,6,2.15,0.961538462,1,0.923076923,1.192307692,1.769230769,0.615384615,34.65116279,30.69767442,34.65116279,30,86.7,0.3125,Uganda-Premier,2022/05/06,2022/05/01 14:00
5,Arua Hill,26,11,10,5,31,25,13,8,4,1,23,13,13,3,6,4,8,12,43,6,2.15,0.961538462,1,0.923076923,1.192307692,1.769230769,0.615384615,34.65116279,30.69767442,34.65116279,30,86.7,0.3125,Uganda-Premier,2022/05/06,2022/05/06 14:00
6,Express FC,27,10,12,5,29,23,13,5,6,2,18,13,14,5,6,3,11,10,42,6,1.93,0.851851852,1,0.714285714,1.074074074,1.384615385,0.785714286,34.65116279,30.69767442,34.65116279,30,90,0.375,Uganda-Premier,2022/05/06,2022/05/07 12:00
7,Onduparaka,27,9,9,9,31,30,13,5,6,2,15,12,14,4,3,7,16,18,36,1,2.26,1.111111111,0.923076923,1.285714286,1.148148148,1.153846154,1.142857143,34.65116279,30.69767442,34.65116279,30,90,0.4375,Uganda-Premier,2022/05/06,2022/05/03 14:00
7,Onduparaka,27,9,9,9,31,30,13,5,6,2,15,12,14,4,3,7,16,18,36,1,2.26,1.111111111,0.923076923,1.285714286,1.148148148,1.153846154,1.142857143,34.65116279,30.69767442,34.65116279,30,90,0.4375,Uganda-Premier,2022/05/06,2022/05/06 14:00
7,Onduparaka,27,9,9,9,31,30,13,5,6,2,15,12,14,4,3,7,16,18,36,1,2.26,1.111111111,0.923076923,1.285714286,1.148148148,1.153846154,1.142857143,34.65116279,30.69767442,34.65116279,30,90,0.4375,Uganda-Premier,2022/05/06,2022/04/30 14:00
8,Wakiso Giant,27,11,3,13,35,42,13,7,0,6,24,23,14,4,3,7,11,19,36,-7,2.85,1.555555556,1.769230769,1.357142857,1.296296296,1.846153846,0.785714286,34.65116279,30.69767442,34.65116279,30,90,0.5,Uganda-Premier,2022/05/06,2022/05/07 14:00
8,Wakiso Giant,27,11,3,13,35,42,13,7,0,6,24,23,14,4,3,7,11,19,36,-7,2.85,1.555555556,1.769230769,1.357142857,1.296296296,1.846153846,0.785714286,34.65116279,30.69767442,34.65116279,30,90,0.5,Uganda-Premier,2022/05/06,2022/05/02 14:00
9,UPDF,27,8,9,10,30,39,14,5,5,4,12,13,13,3,4,6,18,26,33,-9,2.56,1.444444444,0.928571429,2,1.111111111,0.857142857,1.384615385,34.65116279,30.69767442,34.65116279,30,90,0.5625,Uganda-Premier,2022/05/06,2022/05/08 14:00
10,Villa Jogoo,27,7,9,11,25,30,13,5,3,5,17,15,14,2,6,6,8,15,30,-5,2.04,1.111111111,1.153846154,1.071428571,0.925925926,1.307692308,0.571428571,34.65116279,30.69767442,34.65116279,30,90,0.625,Uganda-Premier,2022/05/06,2022/05/07 14:00
10,Villa Jogoo,27,7,9,11,25,30,13,5,3,5,17,15,14,2,6,6,8,15,30,-5,2.04,1.111111111,1.153846154,1.071428571,0.925925926,1.307692308,0.571428571,34.65116279,30.69767442,34.65116279,30,90,0.625,Uganda-Premier,2022/05/06,2022/05/02 14:00
11,Bright Stars,27,7,9,11,20,30,14,5,6,3,10,8,13,2,3,8,10,22,30,-10,1.85,1.111111111,0.571428571,1.692307692,0.740740741,0.714285714,0.769230769,34.65116279,30.69767442,34.65116279,30,90,0.6875,Uganda-Premier,2022/05/06,2022/04/30 14:00
11,Bright Stars,27,7,9,11,20,30,14,5,6,3,10,8,13,2,3,8,10,22,30,-10,1.85,1.111111111,0.571428571,1.692307692,0.740740741,0.714285714,0.769230769,34.65116279,30.69767442,34.65116279,30,90,0.6875,Uganda-Premier,2022/05/06,2022/05/03 14:00
11,Bright Stars,27,7,9,11,20,30,14,5,6,3,10,8,13,2,3,8,10,22,30,-10,1.85,1.111111111,0.571428571,1.692307692,0.740740741,0.714285714,0.769230769,34.65116279,30.69767442,34.65116279,30,90,0.6875,Uganda-Premier,2022/05/06,2022/05/07 14:00
12,Busoga,27,8,5,14,21,39,14,5,3,6,10,14,13,3,2,8,11,25,29,-18,2.22,1.444444444,1,1.923076923,0.777777778,0.714285714,0.846153846,34.65116279,30.69767442,34.65116279,30,90,0.75,Uganda-Premier,2022/05/06,2022/05/02 14:00
12,Busoga,27,8,5,14,21,39,14,5,3,6,10,14,13,3,2,8,11,25,29,-18,2.22,1.444444444,1,1.923076923,0.777777778,0.714285714,0.846153846,34.65116279,30.69767442,34.65116279,30,90,0.75,Uganda-Premier,2022/05/06,2022/05/07 14:00
13,Gadaffi,27,6,10,11,23,35,13,5,4,4,12,15,14,1,6,7,11,20,28,-12,2.15,1.296296296,1.153846154,1.428571429,0.851851852,0.923076923,0.785714286,34.65116279,30.69767442,34.65116279,30,90,0.8125,Uganda-Premier,2022/05/06,2022/05/06 14:00
13,Gadaffi,27,6,10,11,23,35,13,5,4,4,12,15,14,1,6,7,11,20,28,-12,2.15,1.296296296,1.153846154,1.428571429,0.851851852,0.923076923,0.785714286,34.65116279,30.69767442,34.65116279,30,90,0.8125,Uganda-Premier,2022/05/06,2022/04/30 14:00
14,Police,26,5,10,11,27,33,14,3,6,5,19,19,12,2,4,6,8,14,25,-6,2.31,1.269230769,1.357142857,1.166666667,1.038461538,1.357142857,0.666666667,34.65116279,30.69767442,34.65116279,30,86.7,0.875,Uganda-Premier,2022/05/06,2022/05/02 14:00
14,Police,26,5,10,11,27,33,14,3,6,5,19,19,12,2,4,6,8,14,25,-6,2.31,1.269230769,1.357142857,1.166666667,1.038461538,1.357142857,0.666666667,34.65116279,30.69767442,34.65116279,30,86.7,0.875,Uganda-Premier,2022/05/06,2022/05/07 14:00
15,Mbarara City,27,5,7,15,19,30,13,5,6,2,16,10,14,0,1,13,3,20,22,-11,1.81,1.111111111,0.769230769,1.428571429,0.703703704,1.230769231,0.214285714,34.65116279,30.69767442,34.65116279,30,90,0.9375,Uganda-Premier,2022/05/06,2022/05/08 14:00
15,Mbarara City,27,5,7,15,19,30,13,5,6,2,16,10,14,0,1,13,3,20,22,-11,1.81,1.111111111,0.769230769,1.428571429,0.703703704,1.230769231,0.214285714,34.65116279,30.69767442,34.65116279,30,90,0.9375,Uganda-Premier,2022/05/06,2022/05/01 14:00
16,Tooro Utd,27,3,4,20,19,56,14,3,3,8,11,22,13,0,1,12,8,34,13,-37,2.78,2.074074074,1.571428571,2.615384615,0.703703704,0.785714286,0.615384615,34.65116279,30.69767442,34.65116279,30,90,1,Uganda-Premier,2022/05/06,2022/05/06 14:00
1,Maldonado,10,7,1,2,17,10,4,3,0,1,7,4,6,4,1,1,10,6,22,7,2.7,1,1,1,1.7,1.75,1.666666667,34.375,31.25,34.375,30,33.3,0.0625,Uruguay-Primera,2022/05/06,2022/05/07 22:00
1,Maldonado,10,7,1,2,17,10,4,3,0,1,7,4,6,4,1,1,10,6,22,7,2.7,1,1,1,1.7,1.75,1.666666667,34.375,31.25,34.375,30,33.3,0.0625,Uruguay-Primera,2022/05/06,2022/04/24 22:30
2,Boston River,10,5,3,2,12,10,6,2,2,2,6,8,4,3,1,0,6,2,18,2,2.2,1,1.333333333,0.5,1.2,1,1.5,34.375,31.25,34.375,30,33.3,0.125,Uruguay-Primera,2022/05/06,2022/04/24 22:30
2,Boston River,10,5,3,2,12,10,6,2,2,2,6,8,4,3,1,0,6,2,18,2,2.2,1,1.333333333,0.5,1.2,1,1.5,34.375,31.25,34.375,30,33.3,0.125,Uruguay-Primera,2022/05/06,2022/05/08 17:00
3,Liverpool M,10,5,2,3,12,4,4,3,0,1,7,1,6,2,2,2,5,3,17,8,1.6,0.4,0.25,0.5,1.2,1.75,0.833333333,34.375,31.25,34.375,30,33.3,0.1875,Uruguay-Primera,2022/05/06,2022/05/07 19:30
3,Liverpool M,10,5,2,3,12,4,4,3,0,1,7,1,6,2,2,2,5,3,17,8,1.6,0.4,0.25,0.5,1.2,1.75,0.833333333,34.375,31.25,34.375,30,33.3,0.1875,Uruguay-Primera,2022/05/06,2022/04/23 17:30
4,M Wanderers,10,4,5,1,12,6,5,2,2,1,4,3,5,2,3,0,8,3,17,6,1.8,0.6,0.6,0.6,1.2,0.8,1.6,34.375,31.25,34.375,30,33.3,0.25,Uruguay-Primera,2022/05/06,2022/04/23 17:30
4,M Wanderers,10,4,5,1,12,6,5,2,2,1,4,3,5,2,3,0,8,3,17,6,1.8,0.6,0.6,0.6,1.2,0.8,1.6,34.375,31.25,34.375,30,33.3,0.25,Uruguay-Primera,2022/05/06,2022/05/08 23:00
5,Nacional Uru,10,4,4,2,19,8,5,1,3,1,5,5,5,3,1,1,14,3,16,11,2.7,0.8,1,0.6,1.9,1,2.8,34.375,31.25,34.375,30,33.3,0.3125,Uruguay-Primera,2022/05/06,2022/05/09 23:30
6,Riv Pla Uru,10,4,4,2,17,11,7,3,3,1,13,7,3,1,1,1,4,4,16,6,2.8,1.1,1,1.333333333,1.7,1.857142857,1.333333333,34.375,31.25,34.375,30,33.3,0.375,Uruguay-Primera,2022/05/06,2022/04/23 20:00
6,Riv Pla Uru,10,4,4,2,17,11,7,3,3,1,13,7,3,1,1,1,4,4,16,6,2.8,1.1,1,1.333333333,1.7,1.857142857,1.333333333,34.375,31.25,34.375,30,33.3,0.375,Uruguay-Primera,2022/05/06,2022/05/07 22:00
7,CA Penarol,10,4,4,2,7,5,4,2,1,1,4,3,6,2,3,1,3,2,16,2,1.2,0.5,0.75,0.333333333,0.7,1,0.5,34.375,31.25,34.375,30,33.3,0.4375,Uruguay-Primera,2022/05/06,2022/05/08 23:00
7,CA Penarol,10,4,4,2,7,5,4,2,1,1,4,3,6,2,3,1,3,2,16,2,1.2,0.5,0.75,0.333333333,0.7,1,0.5,34.375,31.25,34.375,30,33.3,0.4375,Uruguay-Primera,2022/05/06,2022/04/23 23:00
8,CA Fenix,10,5,1,4,12,13,6,4,0,2,7,6,4,1,1,2,5,7,16,-1,2.5,1.3,1,1.75,1.2,1.166666667,1.25,34.375,31.25,34.375,30,33.3,0.5,Uruguay-Primera,2022/05/06,2022/04/24 20:15
8,CA Fenix,10,5,1,4,12,13,6,4,0,2,7,6,4,1,1,2,5,7,16,-1,2.5,1.3,1,1.75,1.2,1.166666667,1.25,34.375,31.25,34.375,30,33.3,0.5,Uruguay-Primera,2022/05/06,2022/05/09 23:30
9,Danubio,10,3,5,2,6,5,4,0,2,2,0,2,6,3,3,0,6,3,14,1,1.1,0.5,0.5,0.5,0.6,0,1,34.375,31.25,34.375,30,33.3,0.5625,Uruguay-Primera,2022/05/06,2022/05/08 19:30
9,Danubio,10,3,5,2,6,5,4,0,2,2,0,2,6,3,3,0,6,3,14,1,1.1,0.5,0.5,0.5,0.6,0,1,34.375,31.25,34.375,30,33.3,0.5625,Uruguay-Primera,2022/05/06,2022/04/23 20:00
10,Def Sporting,10,3,4,3,8,11,6,2,2,2,6,9,4,1,2,1,2,2,13,-3,1.9,1.1,1.5,0.5,0.8,1,0.5,34.375,31.25,34.375,30,33.3,0.625,Uruguay-Primera,2022/05/06,2022/04/26 00:00
10,Def Sporting,10,3,4,3,8,11,6,2,2,2,6,9,4,1,2,1,2,2,13,-3,1.9,1.1,1.5,0.5,0.8,1,0.5,34.375,31.25,34.375,30,33.3,0.625,Uruguay-Primera,2022/05/06,2022/05/07 17:00
11,Rentistas,10,3,1,6,12,17,4,0,1,3,2,9,6,3,0,3,10,8,10,-5,2.9,1.7,2.25,1.333333333,1.2,0.5,1.666666667,34.375,31.25,34.375,30,33.3,0.6875,Uruguay-Primera,2022/05/06,2022/05/08 17:00
11,Rentistas,10,3,1,6,12,17,4,0,1,3,2,9,6,3,0,3,10,8,10,-5,2.9,1.7,2.25,1.333333333,1.2,0.5,1.666666667,34.375,31.25,34.375,30,33.3,0.6875,Uruguay-Primera,2022/05/06,2022/04/25 01:00
12,Montevideo,10,2,3,5,11,13,6,1,2,3,6,7,4,1,1,2,5,6,9,-2,2.4,1.3,1.166666667,1.5,1.1,1,1.25,34.375,31.25,34.375,30,33.3,0.75,Uruguay-Primera,2022/05/06,2022/04/23 23:00
12,Montevideo,10,2,3,5,11,13,6,1,2,3,6,7,4,1,1,2,5,6,9,-2,2.4,1.3,1.166666667,1.5,1.1,1,1.25,34.375,31.25,34.375,30,33.3,0.75,Uruguay-Primera,2022/05/06,2022/05/06 23:15
13,Albion Uru,10,2,3,5,13,22,5,1,2,2,8,10,5,1,1,3,5,12,9,-9,3.5,2.2,2,2.4,1.3,1.6,1,34.375,31.25,34.375,30,33.3,0.8125,Uruguay-Primera,2022/05/06,2022/05/07 17:00
13,Albion Uru,10,2,3,5,13,22,5,1,2,2,8,10,5,1,1,3,5,12,9,-9,3.5,2.2,2,2.4,1.3,1.6,1,34.375,31.25,34.375,30,33.3,0.8125,Uruguay-Primera,2022/05/06,2022/04/24 20:15
14,Plaza Colonia,10,1,5,4,9,11,5,0,3,2,3,7,5,1,2,2,6,4,8,-2,2,1.1,1.4,0.8,0.9,0.6,1.2,34.375,31.25,34.375,30,33.3,0.875,Uruguay-Primera,2022/05/06,2022/04/25 01:00
14,Plaza Colonia,10,1,5,4,9,11,5,0,3,2,3,7,5,1,2,2,6,4,8,-2,2,1.1,1.4,0.8,0.9,0.6,1.2,34.375,31.25,34.375,30,33.3,0.875,Uruguay-Primera,2022/05/06,2022/05/07 19:30
15,CS Cerrito,10,2,2,6,4,12,5,1,1,3,2,6,5,1,1,3,2,6,8,-8,1.6,1.2,1.2,1.2,0.4,0.4,0.4,34.375,31.25,34.375,30,33.3,0.9375,Uruguay-Primera,2022/05/06,2022/05/06 23:15
15,CS Cerrito,10,2,2,6,4,12,5,1,1,3,2,6,5,1,1,3,2,6,8,-8,1.6,1.2,1.2,1.2,0.4,0.4,0.4,34.375,31.25,34.375,30,33.3,0.9375,Uruguay-Primera,2022/05/06,2022/04/26 00:00
16,Cerro Largo,10,1,3,6,4,17,4,1,1,2,1,7,6,0,2,4,3,10,6,-13,2.1,1.7,1.75,1.666666667,0.4,0.25,0.5,34.375,31.25,34.375,30,33.3,1,Uruguay-Primera,2022/05/06,2022/05/08 19:30
1,Sogdiana,6,4,2,0,8,3,3,2,1,0,4,1,3,2,1,0,4,2,14,5,1.83,0.5,0.333333333,0.666666667,1.333333333,1.333333333,1.333333333,36.58536585,26.82926829,36.58536585,26,23.1,0.071428571,Uzbekistan-Super-League,2022/05/06,2022/05/01 14:35
1,Sogdiana,6,4,2,0,8,3,3,2,1,0,4,1,3,2,1,0,4,2,14,5,1.83,0.5,0.333333333,0.666666667,1.333333333,1.333333333,1.333333333,36.58536585,26.82926829,36.58536585,26,23.1,0.071428571,Uzbekistan-Super-League,2022/05/06,2022/05/07 14:00
2,Qizilqum,6,4,1,1,10,3,4,3,0,1,9,3,2,1,1,0,1,0,13,7,2.17,0.5,0.75,0,1.666666667,2.25,0.5,36.58536585,26.82926829,36.58536585,26,23.1,0.142857143,Uzbekistan-Super-League,2022/05/06,2022/05/01 14:30
2,Qizilqum,6,4,1,1,10,3,4,3,0,1,9,3,2,1,1,0,1,0,13,7,2.17,0.5,0.75,0,1.666666667,2.25,0.5,36.58536585,26.82926829,36.58536585,26,23.1,0.142857143,Uzbekistan-Super-League,2022/05/06,2022/05/06 14:30
3,Pakhtakor Tas,5,3,2,0,5,1,3,2,1,0,2,0,2,1,1,0,3,1,11,4,1.2,0.2,0,0.5,1,0.666666667,1.5,36.58536585,26.82926829,36.58536585,26,19.2,0.214285714,Uzbekistan-Super-League,2022/05/06,2022/05/02 14:30
3,Pakhtakor Tas,5,3,2,0,5,1,3,2,1,0,2,0,2,1,1,0,3,1,11,4,1.2,0.2,0,0.5,1,0.666666667,1.5,36.58536585,26.82926829,36.58536585,26,19.2,0.214285714,Uzbekistan-Super-League,2022/05/06,2022/05/07 15:00
4,Navbahor Nam,6,3,1,2,7,5,3,1,1,1,3,2,3,2,0,1,4,3,10,2,2,0.833333333,0.666666667,1,1.166666667,1,1.333333333,36.58536585,26.82926829,36.58536585,26,23.1,0.285714286,Uzbekistan-Super-League,2022/05/06,2022/05/06 14:30
4,Navbahor Nam,6,3,1,2,7,5,3,1,1,1,3,2,3,2,0,1,4,3,10,2,2,0.833333333,0.666666667,1,1.166666667,1,1.333333333,36.58536585,26.82926829,36.58536585,26,23.1,0.285714286,Uzbekistan-Super-League,2022/05/06,2022/05/01 14:30
5,Bunyodkor,6,3,1,2,9,11,4,2,1,1,5,7,2,1,0,1,4,4,10,-2,3.33,1.833333333,1.75,2,1.5,1.25,2,36.58536585,26.82926829,36.58536585,26,23.1,0.357142857,Uzbekistan-Super-League,2022/05/06,2022/05/10 15:00
5,Bunyodkor,6,3,1,2,9,11,4,2,1,1,5,7,2,1,0,1,4,4,10,-2,3.33,1.833333333,1.75,2,1.5,1.25,2,36.58536585,26.82926829,36.58536585,26,23.1,0.357142857,Uzbekistan-Super-League,2022/05/06,2022/05/06 14:30
6,Lok Tashkent,7,3,0,4,7,9,3,2,0,1,4,2,4,1,0,3,3,7,9,-2,2.29,1.285714286,0.666666667,1.75,1,1.333333333,0.75,36.58536585,26.82926829,36.58536585,26,26.9,0.428571429,Uzbekistan-Super-League,2022/05/06,2022/05/01 14:30
6,Lok Tashkent,7,3,0,4,7,9,3,2,0,1,4,2,4,1,0,3,3,7,9,-2,2.29,1.285714286,0.666666667,1.75,1,1.333333333,0.75,36.58536585,26.82926829,36.58536585,26,26.9,0.428571429,Uzbekistan-Super-League,2022/05/06,2022/05/05 14:30
7,Nasaf Qarshi,4,2,2,0,3,1,1,0,1,0,1,1,3,2,1,0,2,0,8,2,1,0.25,1,0,0.75,1,0.666666667,36.58536585,26.82926829,36.58536585,26,15.4,0.5,Uzbekistan-Super-League,2022/05/06,2022/05/07 15:00
7,Nasaf Qarshi,4,2,2,0,3,1,1,0,1,0,1,1,3,2,1,0,2,0,8,2,1,0.25,1,0,0.75,1,0.666666667,36.58536585,26.82926829,36.58536585,26,15.4,0.5,Uzbekistan-Super-League,2022/05/06,2022/05/02 14:30
8,FK Olympic,7,1,4,2,8,6,4,0,3,1,2,3,3,1,1,1,6,3,7,2,2,0.857142857,0.75,1,1.142857143,0.5,2,36.58536585,26.82926829,36.58536585,26,26.9,0.571428571,Uzbekistan-Super-League,2022/05/06,2022/05/05 14:30
8,FK Olympic,7,1,4,2,8,6,4,0,3,1,2,3,3,1,1,1,6,3,7,2,2,0.857142857,0.75,1,1.142857143,0.5,2,36.58536585,26.82926829,36.58536585,26,26.9,0.571428571,Uzbekistan-Super-League,2022/05/06,2022/05/10 15:00
9,AGMK,5,2,1,2,6,4,1,1,0,0,3,0,4,1,1,2,3,4,7,2,2,0.8,0,1,1.2,3,0.75,36.58536585,26.82926829,36.58536585,26,19.2,0.642857143,Uzbekistan-Super-League,2022/05/06,2022/05/07 14:00
9,AGMK,5,2,1,2,6,4,1,1,0,0,3,0,4,1,1,2,3,4,7,2,2,0.8,0,1,1.2,3,0.75,36.58536585,26.82926829,36.58536585,26,19.2,0.642857143,Uzbekistan-Super-League,2022/05/06,2022/05/02 14:30
10,Dinamo Samar,7,1,3,3,6,8,4,1,2,1,4,4,3,0,1,2,2,4,6,-2,2,1.142857143,1,1.333333333,0.857142857,1,0.666666667,36.58536585,26.82926829,36.58536585,26,26.9,0.714285714,Uzbekistan-Super-League,2022/05/06,2022/04/30 14:40
10,Dinamo Samar,7,1,3,3,6,8,4,1,2,1,4,4,3,0,1,2,2,4,6,-2,2,1.142857143,1,1.333333333,0.857142857,1,0.666666667,36.58536585,26.82926829,36.58536585,26,26.9,0.714285714,Uzbekistan-Super-League,2022/05/06,2022/05/05 14:30
11,Kokand 1912,6,2,0,4,2,7,3,2,0,1,2,1,3,0,0,3,0,6,6,-5,1.5,1.166666667,0.333333333,2,0.333333333,0.666666667,0,36.58536585,26.82926829,36.58536585,26,23.1,0.785714286,Uzbekistan-Super-League,2022/05/06,2022/05/02 14:30
11,Kokand 1912,6,2,0,4,2,7,3,2,0,1,2,1,3,0,0,3,0,6,6,-5,1.5,1.166666667,0.333333333,2,0.333333333,0.666666667,0,36.58536585,26.82926829,36.58536585,26,23.1,0.785714286,Uzbekistan-Super-League,2022/05/06,2022/05/06 14:30
12,Met Bekobod,5,1,2,2,2,4,2,1,1,0,1,0,3,0,1,2,1,4,5,-2,1.2,0.8,0,1.333333333,0.4,0.5,0.333333333,36.58536585,26.82926829,36.58536585,26,19.2,0.857142857,Uzbekistan-Super-League,2022/05/06,2022/05/06 14:30
12,Met Bekobod,5,1,2,2,2,4,2,1,1,0,1,0,3,0,1,2,1,4,5,-2,1.2,0.8,0,1.333333333,0.4,0.5,0.333333333,36.58536585,26.82926829,36.58536585,26,19.2,0.857142857,Uzbekistan-Super-League,2022/05/06,2022/05/01 14:35
12,Met Bekobod,5,1,2,2,2,4,2,1,1,0,1,0,3,0,1,2,1,4,5,-2,1.2,0.8,0,1.333333333,0.4,0.5,0.333333333,36.58536585,26.82926829,36.58536585,26,19.2,0.857142857,Uzbekistan-Super-League,2022/05/06,2022/05/10 15:00
13,Neft Fargona,7,1,1,5,4,11,4,1,0,3,3,6,3,0,1,2,1,5,4,-7,2.14,1.571428571,1.5,1.666666667,0.571428571,0.75,0.333333333,36.58536585,26.82926829,36.58536585,26,26.9,0.928571429,Uzbekistan-Super-League,2022/05/06,2022/05/05 14:30
13,Neft Fargona,7,1,1,5,4,11,4,1,0,3,3,6,3,0,1,2,1,5,4,-7,2.14,1.571428571,1.5,1.666666667,0.571428571,0.75,0.333333333,36.58536585,26.82926829,36.58536585,26,26.9,0.928571429,Uzbekistan-Super-League,2022/05/06,2022/05/10 15:00
13,Neft Fargona,7,1,1,5,4,11,4,1,0,3,3,6,3,0,1,2,1,5,4,-7,2.14,1.571428571,1.5,1.666666667,0.571428571,0.75,0.333333333,36.58536585,26.82926829,36.58536585,26,26.9,0.928571429,Uzbekistan-Super-League,2022/05/06,2022/04/30 14:40
14,Termez Surkh,5,0,2,3,2,6,2,0,0,2,2,4,3,0,2,1,0,2,2,-4,1.6,1.2,2,0.666666667,0.4,1,0,36.58536585,26.82926829,36.58536585,26,19.2,1,Uzbekistan-Super-League,2022/05/06,2022/05/06 14:30
14,Termez Surkh,5,0,2,3,2,6,2,0,0,2,2,4,3,0,2,1,0,2,2,-4,1.6,1.2,2,0.666666667,0.4,1,0,36.58536585,26.82926829,36.58536585,26,19.2,1,Uzbekistan-Super-League,2022/05/06,2022/05/01 14:30
1,Mon Maturin,10,6,2,2,16,11,4,3,0,1,7,5,6,3,2,1,9,6,20,5,2.7,1.1,1.25,1,1.6,1.75,1.5,31.70731707,36.58536585,31.70731707,30,33.3,0.0625,Venezuela-Primera,2022/05/06,2022/05/06 22:15
1,Mon Maturin,10,6,2,2,16,11,4,3,0,1,7,5,6,3,2,1,9,6,20,5,2.7,1.1,1.25,1,1.6,1.75,1.5,31.70731707,36.58536585,31.70731707,30,33.3,0.0625,Venezuela-Primera,2022/05/06,2022/04/30 22:15
2,Metropolitan,10,5,2,3,15,7,4,3,1,0,10,0,6,2,1,3,5,7,17,8,2.2,0.7,0,1.166666667,1.5,2.5,0.833333333,31.70731707,36.58536585,31.70731707,30,33.3,0.125,Venezuela-Primera,2022/05/06,2022/05/07 20:00
2,Metropolitan,10,5,2,3,15,7,4,3,1,0,10,0,6,2,1,3,5,7,17,8,2.2,0.7,0,1.166666667,1.5,2.5,0.833333333,31.70731707,36.58536585,31.70731707,30,33.3,0.125,Venezuela-Primera,2022/05/06,2022/05/01 23:15
3,Herman Colme,11,5,2,4,16,13,6,3,1,2,12,8,5,2,1,2,4,5,17,3,2.64,1.181818182,1.333333333,1,1.454545455,2,0.8,31.70731707,36.58536585,31.70731707,30,36.7,0.1875,Venezuela-Primera,2022/05/06,2022/05/01 00:30
3,Herman Colme,11,5,2,4,16,13,6,3,1,2,12,8,5,2,1,2,4,5,17,3,2.64,1.181818182,1.333333333,1,1.454545455,2,0.8,31.70731707,36.58536585,31.70731707,30,36.7,0.1875,Venezuela-Primera,2022/05/06,2022/05/05 22:15
4,Zamora Bar,11,3,7,1,12,7,6,2,3,1,6,3,5,1,4,0,6,4,16,5,1.73,0.636363636,0.5,0.8,1.090909091,1,1.2,31.70731707,36.58536585,31.70731707,30,36.7,0.25,Venezuela-Primera,2022/05/06,2022/05/06 00:30
5,Dep Guaira,10,4,4,2,18,14,6,3,2,1,11,8,4,1,2,1,7,6,16,4,3.2,1.4,1.333333333,1.5,1.8,1.833333333,1.75,31.70731707,36.58536585,31.70731707,30,33.3,0.3125,Venezuela-Primera,2022/05/06,2022/04/29 22:15
5,Dep Guaira,10,4,4,2,18,14,6,3,2,1,11,8,4,1,2,1,7,6,16,4,3.2,1.4,1.333333333,1.5,1.8,1.833333333,1.75,31.70731707,36.58536585,31.70731707,30,33.3,0.3125,Venezuela-Primera,2022/05/06,2022/05/07 22:15
6,Car Valencia,10,3,6,1,12,8,5,2,2,1,8,5,5,1,4,0,4,3,15,4,2,0.8,1,0.6,1.2,1.6,0.8,31.70731707,36.58536585,31.70731707,30,33.3,0.375,Venezuela-Primera,2022/05/06,2022/05/07 00:30
6,Car Valencia,10,3,6,1,12,8,5,2,2,1,8,5,5,1,4,0,4,3,15,4,2,0.8,1,0.6,1.2,1.6,0.8,31.70731707,36.58536585,31.70731707,30,33.3,0.375,Venezuela-Primera,2022/05/06,2022/05/01 00:30
7,Dep Tachira,10,4,3,3,16,14,5,2,3,0,10,5,5,2,0,3,6,9,15,2,3,1.4,1,1.8,1.6,2,1.2,31.70731707,36.58536585,31.70731707,30,33.3,0.4375,Venezuela-Primera,2022/05/06,2022/04/29 22:15
7,Dep Tachira,10,4,3,3,16,14,5,2,3,0,10,5,5,2,0,3,6,9,15,2,3,1.4,1,1.8,1.6,2,1.2,31.70731707,36.58536585,31.70731707,30,33.3,0.4375,Venezuela-Primera,2022/05/06,2022/05/07 20:00
8,Caracas FC,10,3,5,2,12,12,6,3,3,0,10,6,4,0,2,2,2,6,14,0,2.4,1.2,1,1.5,1.2,1.666666667,0.5,31.70731707,36.58536585,31.70731707,30,33.3,0.5,Venezuela-Primera,2022/05/06,2022/04/30 22:15
8,Caracas FC,10,3,5,2,12,12,6,3,3,0,10,6,4,0,2,2,2,6,14,0,2.4,1.2,1,1.5,1.2,1.666666667,0.5,31.70731707,36.58536585,31.70731707,30,33.3,0.5,Venezuela-Primera,2022/05/06,2022/05/08 00:30
9,Por Acarigua,11,2,7,2,9,9,5,1,3,1,3,4,6,1,4,1,6,5,13,0,1.64,0.818181818,0.8,0.833333333,0.818181818,0.6,1,31.70731707,36.58536585,31.70731707,30,36.7,0.5625,Venezuela-Primera,2022/05/06,2022/05/01 23:15
9,Por Acarigua,11,2,7,2,9,9,5,1,3,1,3,4,6,1,4,1,6,5,13,0,1.64,0.818181818,0.8,0.833333333,0.818181818,0.6,1,31.70731707,36.58536585,31.70731707,30,36.7,0.5625,Venezuela-Primera,2022/05/06,2022/05/06 00:30
10,Min Guayana,10,4,1,5,10,18,5,2,0,3,4,9,5,2,1,2,6,9,13,-8,2.8,1.8,1.8,1.8,1,0.8,1.2,31.70731707,36.58536585,31.70731707,30,33.3,0.625,Venezuela-Primera,2022/05/06,2022/05/07 22:15
10,Min Guayana,10,4,1,5,10,18,5,2,0,3,4,9,5,2,1,2,6,9,13,-8,2.8,1.8,1.8,1.8,1,0.8,1.2,31.70731707,36.58536585,31.70731707,30,33.3,0.625,Venezuela-Primera,2022/05/06,2022/05/01 16:00
11,Estud Merida,10,3,3,4,10,11,5,2,2,1,7,5,5,1,1,3,3,6,12,-1,2.1,1.1,1,1.2,1,1.4,0.6,31.70731707,36.58536585,31.70731707,30,33.3,0.6875,Venezuela-Primera,2022/05/06,2022/05/08 00:30
11,Estud Merida,10,3,3,4,10,11,5,2,2,1,7,5,5,1,1,3,3,6,12,-1,2.1,1.1,1,1.2,1,1.4,0.6,31.70731707,36.58536585,31.70731707,30,33.3,0.6875,Venezuela-Primera,2022/05/06,2022/04/30 00:30
12,Guar De Lara,11,3,3,5,8,11,5,1,2,2,3,4,6,2,1,3,5,7,12,-3,1.73,1,0.8,1.166666667,0.727272727,0.6,0.833333333,31.70731707,36.58536585,31.70731707,30,36.7,0.75,Venezuela-Primera,2022/05/06,2022/05/05 22:15
12,Guar De Lara,11,3,3,5,8,11,5,1,2,2,3,4,6,2,1,3,5,7,12,-3,1.73,1,0.8,1.166666667,0.727272727,0.6,0.833333333,31.70731707,36.58536585,31.70731707,30,36.7,0.75,Venezuela-Primera,2022/05/06,2022/04/29 00:30
13,Ac Pu Cabello,10,3,3,4,9,14,5,2,2,1,4,4,5,1,1,3,5,10,12,-5,2.3,1.4,0.8,2,0.9,0.8,1,31.70731707,36.58536585,31.70731707,30,33.3,0.8125,Venezuela-Primera,2022/05/06,2022/04/30 00:30
13,Ac Pu Cabello,10,3,3,4,9,14,5,2,2,1,4,4,5,1,1,3,5,10,12,-5,2.3,1.4,0.8,2,0.9,0.8,1,31.70731707,36.58536585,31.70731707,30,33.3,0.8125,Venezuela-Primera,2022/05/06,2022/05/08 20:00
14,Aragua FC,10,2,5,3,11,10,5,1,3,1,3,3,5,1,2,2,8,7,11,1,2.1,1,0.6,1.4,1.1,0.6,1.6,31.70731707,36.58536585,31.70731707,30,33.3,0.875,Venezuela-Primera,2022/05/06,2022/04/29 00:30
14,Aragua FC,10,2,5,3,11,10,5,1,3,1,3,3,5,1,2,2,8,7,11,1,2.1,1,0.6,1.4,1.1,0.6,1.6,31.70731707,36.58536585,31.70731707,30,33.3,0.875,Venezuela-Primera,2022/05/06,2022/05/06 22:15
15,UCV,10,1,4,5,4,11,5,1,2,2,2,4,5,0,2,3,2,7,7,-7,1.5,1.1,0.8,1.4,0.4,0.4,0.4,31.70731707,36.58536585,31.70731707,30,33.3,0.9375,Venezuela-Primera,2022/05/06,2022/05/01 16:00
15,UCV,10,1,4,5,4,11,5,1,2,2,2,4,5,0,2,3,2,7,7,-7,1.5,1.1,0.8,1.4,0.4,0.4,0.4,31.70731707,36.58536585,31.70731707,30,33.3,0.9375,Venezuela-Primera,2022/05/06,2022/05/08 20:00
16,Zulia FC,10,1,3,6,7,15,5,0,1,4,3,9,5,1,2,2,4,6,6,-8,2.2,1.5,1.8,1.2,0.7,0.6,0.8,31.70731707,36.58536585,31.70731707,30,33.3,1,Venezuela-Primera,2022/05/06,2022/05/07 00:30
1,Dynamos,13,9,2,2,16,5,7,6,0,1,10,3,6,3,2,1,6,2,29,11,1.62,0.384615385,0.428571429,0.333333333,1.230769231,1.428571429,1,33.18965517,33.62068966,33.18965517,34,38.2,0.055555556,Zimbabwe-Premier,2022/05/06,2022/05/08 14:00
2,Chicken Inn,13,8,3,2,19,11,7,6,1,0,14,5,6,2,2,2,5,6,27,8,2.31,0.846153846,0.714285714,1,1.461538462,2,0.833333333,33.18965517,33.62068966,33.18965517,34,38.2,0.111111111,Zimbabwe-Premier,2022/05/06,2022/05/07 14:00
2,Chicken Inn,13,8,3,2,19,11,7,6,1,0,14,5,6,2,2,2,5,6,27,8,2.31,0.846153846,0.714285714,1,1.461538462,2,0.833333333,33.18965517,33.62068966,33.18965517,34,38.2,0.111111111,Zimbabwe-Premier,2022/05/06,2022/05/01 14:00
3,Manica,13,6,5,2,22,12,7,5,2,0,14,3,6,1,3,2,8,9,23,10,2.62,0.923076923,0.428571429,1.5,1.692307692,2,1.333333333,33.18965517,33.62068966,33.18965517,34,38.2,0.166666667,Zimbabwe-Premier,2022/05/06,2022/05/01 14:00
3,Manica,13,6,5,2,22,12,7,5,2,0,14,3,6,1,3,2,8,9,23,10,2.62,0.923076923,0.428571429,1.5,1.692307692,2,1.333333333,33.18965517,33.62068966,33.18965517,34,38.2,0.166666667,Zimbabwe-Premier,2022/05/06,2022/05/07 14:00
4,Triangle Utd,13,6,4,3,15,9,6,4,2,0,8,2,7,2,2,3,7,7,22,6,1.85,0.692307692,0.333333333,1,1.153846154,1.333333333,1,33.18965517,33.62068966,33.18965517,34,38.2,0.222222222,Zimbabwe-Premier,2022/05/06,2022/05/08 14:00
5,Ngezi Platnm,13,5,5,3,15,7,7,3,2,2,12,5,6,2,3,1,3,2,20,8,1.69,0.538461538,0.714285714,0.333333333,1.153846154,1.714285714,0.5,33.18965517,33.62068966,33.18965517,34,38.2,0.277777778,Zimbabwe-Premier,2022/05/06,2022/04/30 14:00
5,Ngezi Platnm,13,5,5,3,15,7,7,3,2,2,12,5,6,2,3,1,3,2,20,8,1.69,0.538461538,0.714285714,0.333333333,1.153846154,1.714285714,0.5,33.18965517,33.62068966,33.18965517,34,38.2,0.277777778,Zimbabwe-Premier,2022/05/06,2022/05/07 14:00
6,Platinum,13,5,5,3,14,8,7,4,2,1,11,4,6,1,3,2,3,4,20,6,1.69,0.615384615,0.571428571,0.666666667,1.076923077,1.571428571,0.5,33.18965517,33.62068966,33.18965517,34,38.2,0.333333333,Zimbabwe-Premier,2022/05/06,2022/05/07 14:00
6,Platinum,13,5,5,3,14,8,7,4,2,1,11,4,6,1,3,2,3,4,20,6,1.69,0.615384615,0.571428571,0.666666667,1.076923077,1.571428571,0.5,33.18965517,33.62068966,33.18965517,34,38.2,0.333333333,Zimbabwe-Premier,2022/05/06,2022/04/30 14:00
7,Black Rhinos,13,5,5,3,17,13,7,4,2,1,11,7,6,1,3,2,6,6,20,4,2.31,1,1,1,1.307692308,1.571428571,1,33.18965517,33.62068966,33.18965517,34,38.2,0.388888889,Zimbabwe-Premier,2022/05/06,2022/04/30 14:00
7,Black Rhinos,13,5,5,3,17,13,7,4,2,1,11,7,6,1,3,2,6,6,20,4,2.31,1,1,1,1.307692308,1.571428571,1,33.18965517,33.62068966,33.18965517,34,38.2,0.388888889,Zimbabwe-Premier,2022/05/06,2022/05/07 14:00
8,Herentals Zm,13,6,2,5,15,16,6,3,2,1,8,6,7,3,0,4,7,10,20,-1,2.38,1.230769231,1,1.428571429,1.153846154,1.333333333,1,33.18965517,33.62068966,33.18965517,34,38.2,0.444444444,Zimbabwe-Premier,2022/05/06,2022/04/30 14:00
8,Herentals Zm,13,6,2,5,15,16,6,3,2,1,8,6,7,3,0,4,7,10,20,-1,2.38,1.230769231,1,1.428571429,1.153846154,1.333333333,1,33.18965517,33.62068966,33.18965517,34,38.2,0.444444444,Zimbabwe-Premier,2022/05/06,2022/05/07 14:00
9,CAPS Utd,12,4,5,3,17,14,5,2,3,0,8,1,7,2,2,3,9,13,17,3,2.58,1.166666667,0.2,1.857142857,1.416666667,1.6,1.285714286,33.18965517,33.62068966,33.18965517,34,35.3,0.5,Zimbabwe-Premier,2022/05/06,2022/05/07 14:00
10,Bulawayo Chi,13,4,5,4,9,9,7,3,2,2,6,5,6,1,3,2,3,4,17,0,1.38,0.692307692,0.714285714,0.666666667,0.692307692,0.857142857,0.5,33.18965517,33.62068966,33.18965517,34,38.2,0.555555556,Zimbabwe-Premier,2022/05/06,2022/05/08 14:00
10,Bulawayo Chi,13,4,5,4,9,9,7,3,2,2,6,5,6,1,3,2,3,4,17,0,1.38,0.692307692,0.714285714,0.666666667,0.692307692,0.857142857,0.5,33.18965517,33.62068966,33.18965517,34,38.2,0.555555556,Zimbabwe-Premier,2022/05/06,2022/04/30 14:00
11,Highlanders,13,3,7,3,14,9,6,3,3,0,12,3,7,0,4,3,2,6,16,5,1.77,0.692307692,0.5,0.857142857,1.076923077,2,0.285714286,33.18965517,33.62068966,33.18965517,34,38.2,0.611111111,Zimbabwe-Premier,2022/05/06,2022/05/01 14:00
11,Highlanders,13,3,7,3,14,9,6,3,3,0,12,3,7,0,4,3,2,6,16,5,1.77,0.692307692,0.5,0.857142857,1.076923077,2,0.285714286,33.18965517,33.62068966,33.18965517,34,38.2,0.611111111,Zimbabwe-Premier,2022/05/06,2022/05/08 14:00
12,Harare City,13,3,6,4,9,10,7,1,4,2,5,6,6,2,2,2,4,4,15,-1,1.46,0.769230769,0.857142857,0.666666667,0.692307692,0.714285714,0.666666667,33.18965517,33.62068966,33.18965517,34,38.2,0.666666667,Zimbabwe-Premier,2022/05/06,2022/05/07 14:00
12,Harare City,13,3,6,4,9,10,7,1,4,2,5,6,6,2,2,2,4,4,15,-1,1.46,0.769230769,0.857142857,0.666666667,0.692307692,0.714285714,0.666666667,33.18965517,33.62068966,33.18965517,34,38.2,0.666666667,Zimbabwe-Premier,2022/05/06,2022/04/30 14:00
13,Cranborne Bu,12,3,4,5,12,17,6,2,3,1,5,5,6,1,1,4,7,12,13,-5,2.42,1.416666667,0.833333333,2,1,0.833333333,1.166666667,33.18965517,33.62068966,33.18965517,34,35.3,0.722222222,Zimbabwe-Premier,2022/05/06,2022/05/06 14:00
14,Tenax CS,13,3,4,6,13,24,6,2,2,2,7,8,7,1,2,4,6,16,13,-11,2.85,1.846153846,1.333333333,2.285714286,1,1.166666667,0.857142857,33.18965517,33.62068966,33.18965517,34,38.2,0.777777778,Zimbabwe-Premier,2022/05/06,2022/05/08 14:00
14,Tenax CS,13,3,4,6,13,24,6,2,2,2,7,8,7,1,2,4,6,16,13,-11,2.85,1.846153846,1.333333333,2.285714286,1,1.166666667,0.857142857,33.18965517,33.62068966,33.18965517,34,38.2,0.777777778,Zimbabwe-Premier,2022/05/06,2022/04/30 14:00
15,Yadah,13,2,6,5,9,13,6,1,4,1,4,4,7,1,2,4,5,9,12,-4,1.69,1,0.666666667,1.285714286,0.692307692,0.666666667,0.714285714,33.18965517,33.62068966,33.18965517,34,38.2,0.833333333,Zimbabwe-Premier,2022/05/06,2022/05/06 14:00
16,ZPC Kariba,13,2,5,6,5,11,7,1,4,2,3,4,6,1,1,4,2,7,11,-6,1.23,0.846153846,0.571428571,1.166666667,0.384615385,0.428571429,0.333333333,33.18965517,33.62068966,33.18965517,34,38.2,0.888888889,Zimbabwe-Premier,2022/05/06,2022/05/07 14:00
16,ZPC Kariba,13,2,5,6,5,11,7,1,4,2,3,4,6,1,1,4,2,7,11,-6,1.23,0.846153846,0.571428571,1.166666667,0.384615385,0.428571429,0.333333333,33.18965517,33.62068966,33.18965517,34,38.2,0.888888889,Zimbabwe-Premier,2022/05/06,2022/05/01 14:00
17,Whawha,13,2,2,9,13,31,6,2,1,3,10,11,7,0,1,6,3,20,8,-18,3.38,2.384615385,1.833333333,2.857142857,1,1.666666667,0.428571429,33.18965517,33.62068966,33.18965517,34,38.2,0.944444444,Zimbabwe-Premier,2022/05/06,2022/05/07 14:00
18,Bulawayo Cy,13,1,3,9,8,23,6,1,0,5,3,9,7,0,3,4,5,14,6,-15,2.38,1.769230769,1.5,2,0.615384615,0.5,0.714285714,33.18965517,33.62068966,33.18965517,34,38.2,1,Zimbabwe-Premier,2022/05/06,2022/04/30 14:00
18,Bulawayo Cy,13,1,3,9,8,23,6,1,0,5,3,9,7,0,3,4,5,14,6,-15,2.38,1.769230769,1.5,2,0.615384615,0.5,0.714285714,33.18965517,33.62068966,33.18965517,34,38.2,1,Zimbabwe-Premier,2022/05/06,2022/05/08 14:00
